```python
import enum

import datetime
import dataclasses

from pydantic import PositiveInt


class MaxStops(enum.Enum):
  ANY = 0
  NON_STOP = 1
  ONE_STOP_OR_FEWER = 2
  TWO_OR_FEWER_STOPS = 3


class SeatType(enum.Enum):
  ECONOMY = 1
  PREMIUM_ECONOMY = 2
  BUSINESS = 3
  FIRST = 4


class PriceLimit:
  max_price: PositiveInt


class Airline(enum.Enum):
  A0 = "Macair Jet"
  A1 = "APG Distribution System"
  A2 = "Astra Airlines"
  A3 = "Aegean Airlines"
  A4 = "Azimuth"
  A5 = "HOP!"
  A6 = "Yunnan Hongtu Airline"
  A7 = "Aéreo Calafia"
  A8 = "Aerolink Uganda"
  A9 = "Georgian Airways"
  AA = "American Airlines"
  AB = "Bonza"
  AC = "Air Canada"
  AD = "Azul Brazilian Airlines"
  AE = "Mandarin Airlines"
  AF = "Air France"
  AG = "Aruba Airlines"
  AH = "Air Algerie"
  AI = "Air India"
  AJ = "Aztec Worldwide Airlines"
  AK = "AirAsia"
  AL = "Air Leisure"
  AM = "AeroMexico"
  AN = "HOP Airlinair"
  AO = "Air Juan Aviation"
  AP = "AlbaStar"
  AQ = "9 Air"
  AR = "Aerolíneas Argentinas"
  AS = "Alaska Airlines"
  AT = "Royal Air Maroc"
  AU = "Austral Líneas Aéreas"
  AV = "Avianca"
  AW = "Africa World Airlines"
  AX = "Trans States Airlines"
  AY = "Finnair"
  AZ = "Alitalia"
  B0 = "La Compagnie"
  B1 = "Cions Software"
  B2 = "Belavia"
  B3 = "Bhutan Airlines"
  B4 = "Zanair"
  B5 = "Fly-SAX"
  B6 = "JetBlue"
  B7 = "Uni Airways"
  B8 = "Eritrean Airlines"
  B9 = "Iran Air Tours"
  BA = "British Airways"
  BB = "Seaborne Airlines"
  BC = "Skymark Airlines"
  BD = "Cambodia Bayon Airlines"
  BE = "Flybe"
  BF = "French Bee"
  BG = "Biman Bangladesh Airline"
  BH = "Hawkair"
  BI = "Royal Brunei"
  BJ = "Nouvelair"
  BK = "Okay Airways"
  BL = "Jetstar Pacific Airlines"
  BM = "bmi regional"
  BN = "Luxwing Ltd"
  BO = "BB Airways"
  BP = "Air Botswana"
  BR = "EVA Air"
  BS = "US-Bangla Airlines"
  BT = "airBaltic"
  BU = "Compagnie Africaine d'Aviation"
  BV = "Blue Panorama Airlines"
  BW = "Caribbean Airlines"
  BX = "Air Busan"
  BY = "Thomson Airways"
  BZ = "Bluebird Airways"
  C0 = "Centralwings"
  C1 = "Tectimes Sudamerica"
  C2 = "Ceiba Intercontinental"
  C3 = "Trade Air"
  C4 = "Alma De Mexico"
  C5 = "CommutAir"
  C6 = "Canjet Airlines"
  C7 = "Cinnamon Air"
  C8 = "Cronos Airlines"
  C9 = "Skywise"
  CA = "Air China"
  CB = "Trans Caribbean Air ExportImport"
  CC = "CM Airlines"
  CD = "Corendon Dutch Airlines"
  CE = "Chalair Aviation"
  CF = "China Postal Airlines"
  CG = "PNG Air"
  CH = "Bemidji Airlines"
  CI = "China Airlines"
  CJ = "BA CityFlyer"
  CK = "China Cargo Airlines"
  CL = "Lufthansa CityLine"
  CM = "Copa Airlines"
  CN = "Grand China Air"
  CO = "Cobalt Air"
  CP = "Compass Airlines"
  CQ = "Coastal Travels"
  CR = "OAG Worldwide"
  CS = "Comlux Aruba"
  CT = "Alitalia CityLiner"
  CU = "Cubana De Aviacion"
  CV = "Cargolux"
  CX = "Cathay Pacific"
  CY = "Charlie Airlines"
  CZ = "China Southern Airlines"
  D0 = "DHL Air UK"
  D2 = "Severstal Air Company"
  D3 = "Daallo Airlines"
  D4 = "DART Ltd"
  D6 = "Interair"
  D7 = "AirAsia X"
  D8 = "Norwegian Air International"
  D9 = "Donavia"
  DA = "Air Georgia"
  DB = "HOP Brit Air"
  DC = "Braathens Regional Airways"
  DD = "Nok Air"
  DE = "Condor"
  DF = "Condor Berlin"
  DG = "Cebgo"
  DH = "Douniah Airlines"
  DI = "Norwegian Air UK"
  DJ = "AirAsia Japan"
  DK = "Thomas Cook Airlines"
  DL = "Delta Air Lines"
  DM = "Arajet"
  DN = "Norwegian Air Argentina"
  DO = "Discovery Airways"
  DP = "Pobeda"
  DQ = "Delta Connection"
  DR = "Ruili Airlines"
  DS = "easyJet Switzerland"
  DT = "Taag"
  DU = "Norwegian Long Haul"
DV = "SCAT Airlines"
  DW = "Great Dane Airlines"
  DX = "Danish Air Transport"
  DY = "Norwegian Air Shuttle (NAS)"
  DZ = "Donghai Airlines"
  E2 = "Eurowings Europe"
  E3 = "New Gen Airways"
  E4 = "Enter Air"
  E5 = "Air Arabia Egypt"
  E6 = "Bringer Air Cargo"
  E7 = "Equaflight Service"
  E8 = "City Airways"
  E9 = "Evelop Airlines"
  EB = "Wamos Air"
  EC = "easyJet Europe"
  ED = "Air Explore"
  EE = "Nordica"
  EF = "Fly CamInter"
  EG = "East Air"
  EH = "ANA Wings"
  EI = "Aer Lingus"
  EJ = "New England Airlines"
  EK = "Emirates"
  EL = "Ellinair"
  EM = "Aero Benin"
  EN = "Air Dolomiti"
  EO = "Air Go Egypt"
  EP = "Iran Aseman Airlines"
  EQ = "TAME"
  ER = "SereneAir"
  ES = "DHL International Aviation ME"
  ET = "Ethiopian Airlines"
  EU = "Chengdu Airlines"
  EV = "ExpressJet Airlines"
  EW = "Eurowings"
  EX = "Avianca Express"
  EY = "Etihad Airways"
  EZ = "Sun Air of Scandinavia"
  F1 = "Farelogix"
  F2 = "Safarilink Aviation"
  F3 = "Flyadeal"
  F4 = "Air Flamenco"
  F6 = "Fly2sky"
  F7 = "Etihad Regional"
  F8 = "Flair Airlines"
  F9 = "Frontier Airlines"
  FA = "Safair"
  FB = "Bulgaria Air"
  FC = "Fly Corporate"
  FD = "Thai AirAsia"
  FE = "Far Eastern Air Transport"
  FG = "Ariana Afghan Airlines"
  FH = "Freebird Airlines"
  FI = "Icelandair"
  FJ = "Fiji Airways"
  FK = "Kelowna Flightcraft Air Charter"
  FL = "Airtran Airways"
  FM = "Shanghai Airlines"
  FN = "Royal Air Maroc Express"
  FO = "Felix Airways"
  FP = "Pelican Airlines"
  FQ = "SOL SA LINEAS AEREAS (DBA Flyest Lineas Aereas)"
  FR = "Ryanair"
  FS = "Flyr"
  FT = "FlyEgypt"
  FU = "Fuzhou Airlines"
  FV = "Rossiya"
  FW = "Ibex Airlines"
  FX = "Fedex"
  FY = "Flyfirefly"
  FZ = "flydubai"
  G0 = "Alianza Glancelot"
  G2 = "Galeyr Airline"
  G3 = "Gol Transportes Aéreos"
  G4 = "Allegiant Air"
  G5 = "China Express Airlines"
  G6 = "Denim Air"
  G7 = "GoJet Airlines"
  G8 = "Go First"
  G9 = "Air Arabia"
  GA = "Garuda Indonesia"
  GB = "ABX Air"
  GC = "Global Feeder Services"
  GD = "Aviair"
  GE = "TransAsia Airways"
  GF = "Gulf Air"
  GG = "Sky Lease Cargo"
  GH = "Globus"
  GI = "Itek Air"
  GJ = "Zhejiang Loong Airlines"
  GK = "Jetstar Japan"
  GL = "Air Greenland"
  GM = "Chair Airlines"
  GO = "Go"
  GP = "APG Airlines"
  GQ = "Sky Express"
  GR = "Aurigny Air Services"
  GS = "Tianjin Airlines"
  GT = "Air Guilin"
  GU = "Aviateca"
  GV = "Grant Aviation"
  GW = "SkyGreece Airlines"
  GX = "Guangxi Beibu Gulf Airlines"
  GY = "Colorful Guizhou Airlines"
  GZ = "Air Rarotonga"
  H1 = "Hahn Air Systems"
  H2 = "Sky Airline"
  H3 = "Harbour Air"
  H6 = "Bulgarian Air Charter"
  H7 = "Eagle Air"
  H8 = "Chilejet"
  H9 = "Himalaya Airlines"
  HA = "Hawaiian Airlines"
  HB = "Asia Atlantic Airlines"
  HC = "Air Senegal"
  HD = "Air Do"
  HE = "LGW Luftfahrtges Walter"
  HF = "Air Cote D Ivoire"
  HH = "Taban Airlines"
  HI = "Papillon Airways"
  HJ = "Hellas Jet"
  HK = "Skippers Aviation"
  HL = ""
  HM = "Air Seychelles"
  HN = "Afghan Jet International"
  HO = "Juneyao Airlines"
  HP = "Amapola Flyg"
  HQ = "Thomas Cook Airlines Belgium"
  HR = "Hahn Air"
  HS = "Heli Sécurité"
  HU = "Hainan Airlines"
  HV = "Transavia Airlines"
  HW = "North Wright Air"
  HX = "Hong Kong Airlines"
  HY = "Uzbekistan Airways"
  HZ = "Aurora Airlines"
  I1 = "CTS Viaggi"
  I2 = "Iberia Express"
  I3 = "ATA Airlines"
  I4 = "Scott Air"
  I5 = "AirAsia India"
  I6 = "Air Indus"
  I7 = "Int'Air Îles"
  I8 = "Izhavia"
  IA = "Iraqi Airways"
  IB = "Iberia"
  IC = "Nacil Indian Airline"
  ID = "Batik Air"
  IE = "Solomon Airlines"
  IF = "FlyBaghdad"
  IG = "Air Italy"
  IH = "Jsc Irtysh Air"
  II = "IBC Airways"
  IJ = "Spring Airlines Japan"
  IK = "Air Kiribati"
  IL = "Trigana Air Service"
  IM = "Mint Líneas Aéreas"
  IN = "NAM Air"
  IO = "IrAero"
  IP = "Iberworld Airlines"
  IQ = "Qazaq Air"
  IR = "Iran Air"
  IS = "AIS Airlines"
  IT = "Tigerair Taiwan"
  IU = "Hevilift"
  IV = "Air Djibouti"
  IW = "Wings Air"
  IX = "Air India Express"
  IY = "Yemen Airways"
  IZ = "Arkia"
  J0 = "Jetlink Express"
  J1 = "OntJet"
  J2 = "Azerbaijan Airlines"
  J3 = "Northwestern Air Lease"
  J4 = "Badr Airlines"
  J5 = "Alaska Seaplane Service"
  J6 = "Jet-Ops"
  J7 = "Afrijet Business Service"
  J8 = "Berjaya Air"
  J9 = "Jazeera Airways"
  JA = "Jetsmart"
  JB = "Helijet International"
  JC = "Japan Air Commuter"
  JD = "Beijing Capital Airlines"
  JE = "Mango"
  JF = "Jet Asia Airways"
  JG = "Jetgo Australia"
  JH = "Fuji Dream Airlines"
  JI = "Eastern Caribbean Airlines"
  JJ = "LATAM Brasil"
  JL = "Japan Airlines"
  JM = "Jambojet"
  JN = "Alaska Air Transit"
  JO = "Jet Time"
  JQ = "Jetstar"
  JR = "Joy Air"
  JS = "Air Koryo"
  JT = "Lion Air"
  JU = "Air Serbia"
  JV = "Bearskin Airlines"
  JW = "Vanilla Air"
  JX = "DAC East Africa"
  JY = "InterCaribbean Airways"
  K3 = "Taquan Air Services"
  K4 = "ALS"
  K5 = "SeaPort"
  K6 = "Cambodia Angkor Air"
  K7 = "Air KBZ"
  K8 = "Kan Air"
  K9 = "Kalitta Charters"
  KA = "Cathay Dragon"
  KB = "Druk Air"
  KC = "Air Astana"
  KD = "Western Global Airlines"
  KE = "Korean Air"
  KF = "Air Belgium"
  KG = "Aerogaviota"
  KH = "Aloha Air Cargo"
  KI = "KrasAvia"
  KJ = "Air Incheon"
  KK = "AtlasGlobal"
  KL = "KLM"
  KM = "Air Malta"
  KN = "China United Airlines"
  KO = "Komiaviatrans"
  KP = "ASKY Airlines"
  KQ = "Kenya Airways"
  KR = "Air Bishkek"
  KS = "Penair"
  KT = "Fly Kiss"
  KU = "Kuwait Airways"
  KV = "Sky Regional Airlines"
  KW = "Kharkiv Airlines"
  KX = "Cayman Airways"
  KY = "Kunming Airlines"
  KZ = "Nippon Cargo Airlines"
  L1 = "E Savtravel"
  L3 = "Lynx Aviation"
  L4 = "Air Service Liege (ASL)"
  L5 = "Atlantique Air Assistance"
  L6 = "Mauritanian Airlines Int"
  L7 = "Lugansk Airlines"
  L8 = "Afric Aviation"
  L9 = "Belle Air Europe"
  LA = "LATAM Chile"
  LB = "Air Costa"
  LC = "ECAir"
  LE = "Norwegian Air Sweden AB"
  LF = "Contour Airlines"
  LG = "Luxair"
  LH = "Lufthansa Cargo"
  LI = "LIAT"
  LJ = "Jin Air"
  LK = "Lao Skyway"
  LL = "Miami Air International"
  LM = "Loganair"
  LN = "Libyan Airlines"
  LO = "LOT Polish Airlines"
  LP = "LATAM Perú"
  LQ = "Lanmei Airlines"
  LR = "Avianca Costa Rica"
  LS = "Jet2.com"
  LT = "Longjiang Airlines"
  LU = "LAN Express"
  LV = "Level"
  LW = "Pacific Wings"
  LX = "Swiss International Air Lines"
  LY = "El Al"
  LZ = "Swiss Global Air Lines"
  M0 = "Aero Mongolia"
  M2 = "MHS Aviation"
  M3 = "Air Norway"
  M4 = "Mistral Air"
  M5 = "Kenmore Air"
  M6 = "Amerijet International"
  M8 = "SKYJET Airlines"
  M9 = "Motor Sich Jsc"
  MB = "Mng Airlines Cargo"
  MC = "Air Mobility Command"
  MD = "Air Madagascar"
  ME = "Middle East Airlines"
  MF = "XiamenAir"
  MG = "Miami Air Lease"
  MH = "Malaysia Airlines"
  MI = "SilkAir"
  MJ = "Mihin Lanka"
  MK = "Air Mauritius"
  ML = "Sky Mali"
  MM = "Peach Aviation"
  MN = "Comair"
  MO = "Calm Air International"
  MP = "Martinair"
  MQ = "Envoy Air"
  MR = "Hunnu Air"
  MS = "EgyptAir"
  MT = "Thomas Cook Airlines"
  MU = "China Eastern Airlines"
  MV = "Air Mediterranean"
  MW = "Mokulele Airlines"
  MX = "Breeze Airways"
  MY = "MASwings"
  MZ = "Amakusa Airlines"
  N0 = "Norse Atlantic Airways"
  N2 = "Dagestan Airlines"
  N3 = "Aerolineas Mas"
  N4 = "Nord Wind"
  N5 = "Nolinor Aviation"
  N6 = "Nomad Aviation"
  N7 = "Nordic Regional Airlines"
  N8 = "National Airlines"
  N9 = "Novair"
  NB = "Skypower Express Airways"
  NC = "Cobham Aviation Services Australia"
  ND = "FMI Air"
  NE = "Nesma Airlines"
  NF = "Air Vanuatu"
  NG = "NovAir"
  NH = "All Nippon Airways"
  NI = "Portugalia"
  NJ = "Niger Airways"
  NK = "Spirit Airlines"
  NL = "Aero4M"
  NM = "Manx"
  NN = "Vim Airlines"
  NO = "Neos"
  NP = "Nile Air"
  NQ = "Air Japan"
  NR = "Manta Air"
  NS = "Hebei Airlines"
  NT = "Binter Canarias"
  NU = "Japan Transocean Air"
  NV = "Iranian Naft Airline"
  NW = "Northwest Airlines"
  NX = "Air Macau"
  NY = "Air Iceland"
  NZ = "Air New Zealand"
  O2 = "Jet Air"
  O4 = "Antrak Air"
  O5 = "Comores Aviation International"
  O7 = "Orenburg Region Airlines"
  O9 = "Nova Airways"
  OA = "Olympic Air"
  OB = "Boliviana de Aviación (BoA)"
  OC = "Oriental Air Bridge"
  OD = "Malindo Airways"
  OE = "Lauda"
  OF = "Overland Airways"
  OG = "Air Freight NZ"
  OH = "PSA Airlines"
  OI = "Hinterland Aviation"
  OJ = "Fly Jamaica Airways"
  OK = "Czech Airlines"
  OL = "Polynesian Airlines"
  OM = "Miat Mongolian Airlines"
  ON = "Nauru Airlines"
  OO = "SkyWest Airlines"
  OP = "Air Pegasus"
  OQ = "Chongqing Airlines"
  OR = "TUI Airlines Netherlands"
  OS = "Austrian Airlines"
  OT = "Tchadia Airlines"
  OU = "Croatia Airlines"
  OV = "SalamAir"
  OW = "Skyward Express"
  OX = "Orient Thai Airlines"
  OY = "Andes Líneas Aéreas"
  OZ = "Asiana Airlines"
  P0 = "Proflight Commuter"
  P1 = "Publiccharters Com"
  P2 = "Airkenya Express"
  P3 = "CargoLogicAir"
  P4 = "Aerolineas Sosa"
  P5 = "Copa Airlines Colombia"
  P6 = "Pascan Aviation"
  P8 = "SprintAir"
  P9 = "Peruvian Airlines"
  PA = "Airblue"
  PB = "Provincial Airlines"
  PC = "Pegasus Airlines"
  PD = "Porter Airlines"
  PE = "Peoples Viennaline"
  PF = "Primera Air Scandinavia"
  PG = "Bangkok Airways"
  PH = "Transavia Denmark"
  PI = "Polar Airlines"
  PJ = "Air Saint Pierre"
  PK = "Pakistan International Airlines (PIA)"
  PL = "Southern Air Charter"
  PM = "Canaryfly"
  PN = "China West Air"
  PO = "Polar Air Cargo"
  PP = "Jet Aviation Business"
  PQ = "AirAsia Philippines"
  PR = "Philippine Airlines"
  PS = "Ukraine International Airlines"
  PT = "Piedmont Airlines"
  PU = "Plus Ultra Líneas Aéreas"
  PV = "Saint Barth Commuter"
  PW = "Precision Air"
  PX = "Air Niugini"
  PY = "Surinam Airways"
  PZ = "LATAM Paraguay"
  Q0 = "Quebecair Express"
  Q1 = "Sqiva Sistem"
  Q2 = "Maldivian"
  Q3 = "Anguilla Air Services"
  Q4 = "Aviation Starlink"
  Q5 = "Forty Mile Air"
  Q7 = "Sky Bahamas Airlines"
  Q8 = "Trans Air Congo"
  Q9 = "Airliaison"
  QA = "Cimber"
  QB = "Qeshm Air"
  QC = "Camair-Co"
  QD = "Dobrolet Airlines"
  QE = "Fars Qeshm Airlines"
  QF = "Qantas"
  QG = "Citilink Indonesia"
  QH = "Air Bamboo"
  QJ = "Latpass Airlines"
  QK = "Jazz Aviation"
  QL = "Linea Aerea De Servicio"
  QM = "Monacair"
  QN = "Skytrans Regional"
  QO = "Quantum Air"
  QP = "Air Kenya Aviation"
  QQ = "Alliance Airlines"
  QR = "Qatar Airways"
  QS = "Smartwings"
  QT = "Tampa Cargo"
  QU = "UTair Ukraine"
  QV = "Lao Airlines"
  QW = "Qingdao Airlines"
  QX = "Horizon Air"
  QY = "European Air Transport"
  QZ = "Indonesia AirAsia"
  R0 = "MS Royal Airlines"
  R2 = "Transair"
  R3 = "Yakutia Airlines"
  R4 = "Real Tonga"
  R5 = "Jordan Aviation"
  R6 = "DOT LT"
  R7 = "Aserca"
  R8 = "Kyrgyzstan Airlines"
  R9 = "TAF Linhas Aereas"
  RA = "Nepal Airlines"
  RB = "Syrian Arab Airlines"
  RC = "Atlantic Airways"
  RE = "Stobart Air"
  RF = "Aero K"
  RG = "Rotana Jet"
  RH = "Robin Hood Aviation"
  RI = "Air Costa Rica"
  RJ = "Royal Jordanian"
  RK = "Region Airline"
  RL = "Royal Flight"
  RM = "Aircompany Armenia"
  RN = "Rayani Air"
  RO = "TAROM"
  RP = "Chautauqua Airlines"
  RQ = "Kam Air"
  RR = "Royal Air Force"
  RS = "Air Seoul"
  RT = "Rainbow Airlines"
  RU = "Air Bridge Cargo"
  RV = "Air Canada Rouge"
  RW = "Royal Air Charter Service"
  RX = "Regent Airways"
  RY = "Jiangxi Air"
  RZ = "SANSA Airlines"
  S0 = "Aerolineas Sosa"
  S1 = "Lufthansa Systems"
  S2 = "Jet Lite"
  S3 = "SBA Airlines"
  S4 = "SATA International"
  S5 = "Shuttle America"
  S6 = "Sunrise Airways"
  S7 = "S7 Airlines"
  S8 = "Sounds Air"
  S9 = "Starbow"
  SA = "South African Airways"
  SB = "Aircalin"
  SC = "Shandong Airlines"
  SD = "Sudan Airways"
  SF = "Tassili Airlines"
  SG = "SpiceJet"
  SH = "Sharp Aviation"
  SI = "Blue Islands"
  SJ = "Sriwijaya Air"
  SK = "Scandinavian Airlines"
  SL = "Thai Lion Air"
  SM = "Air Cairo"
  SN = "Brussels Airlines"
  SO = "Apex Airline"
  SP = "SATA Air Açores"
  SQ = "Singapore Airlines"
  SR = "SundAir"
  SS = "Corsair"
  ST = "Germania"
  SU = "Aeroflot"
  SV = "Saudia"
  SW = "Air Namibia"
  SX = "SkyWork Airlines"
  SY = "Sun Country"
  SZ = "Somon Air"
  T0 = "Avianca Perú"
  T1 = "Tik Systems"
  T2 = "Fly Art"
  T3 = "Eastern Airways"
  T4 = "Trip"
  T5 = "Turkmenistan Airlines"
  T6 = "ITI Air"
  T7 = "Twin Jet"
  T9 = "Aviator Aviation"
  TA = "Avianca El Salvador"
  TB = "TUIfly Belgium"
  TC = "Air Tanzania"
  TD = "Atlantis European Airways"
  TE = "Sky Taxi"
  TF = "Braathens Regional Aviation"
  TG = "Thai Airways"
  TH = "Raya Airways"
  TI = "Tailwind Hava Yollari As"
  TJ = "Tradewind Aviation"
  TK = "Turkish Airlines"
  TL = "Airnorth"
  TM = "Lam Mozambique"
  TN = "Air Tahiti Nui"
  TO = "Transavia France"
  TP = "TAP Portugal"
  TQ = "Tandem Aero"
  TR = "Scoot"
  TS = "Air Transat"
  TT = "Tigerair Australia"
  TU = "Tunisair"
  TV = "Tibet Airlines"
  TW = "T'way Air"
  TX = "Air Caraibes"
  TY = "Air Caledonie"
  U1 = "Videcom International"
  U2 = "easyJet"
  U3 = "Avies"
  U4 = "Buddha Air"
  U5 = "Karinou Airlines"
  U6 = "Ural Airlines"
  U7 = "Air Uganda"
  U8 = "Tus Airways"
  U9 = "Tatarstan Air"
  UA = "United Airlines"
  UB = "Myanmar National Airlines"
  UC = "LAN Cargo"
  UD = "Hex Air"
  UE = "Nasair"
  UF = "Um Air"
  UG = "Tunisair Express"
  UH = "AtlasJet Ukraine"
  UI = "Auric Air Services"
  UJ = "AlMasria Universal Airlines"
  UK = "Vistara"
  UL = "SriLankan Airlines"
  UM = "Air Zimbabwe"
  UN = "Transaero Airlines"
  UO = "Hong Kong Express Airways"
  UP = "Bahamasair"
  UQ = "Business Aviation Centre"
  UR = "Uganda Airlines"
  US = "US Airways"
  UT = "UTair Aviation"
  UU = "Air Austral"
  UV = "Helicopteros Del Sureste"
  UX = "Air Europa"
  UY = "Sky Prime Charter"
  UZ = "Buraq Air"
  V0 = "Conviasa"
  V1 = "IBS Software Services Americas"
  V2 = "Vision Airlines"
  V3 = "Carpatair"
  V4 = "Vieques Air Link"
  V5 = "Aerovias DAP"
  V6 = "Air Link"
  V7 = "Volotea"
  V8 = "Iliamna Air"
  V9 = "Van Air Europe"
  VA = "Virgin Australia"
  VB = "Aeroenlaces Nacionales"
  VC = "ViaAir"
  VD = "Hennan Airlines"
  VE = "EasyFly"
  VF = "Fly Armenia Airways"
  VG = "VLM Airlines"
  VH = "Viva Air Colombia"
  VI = "Volga Dnepr Airline"
  VJ = "VietJet Air"
  VK = "Anisec Luftfahrt"
  VL = "Air VIA"
  VM = "Max Air"
  VN = "Vietnam Airlines"
  VO = "VLM Airlines Slovenia"
  VP = "Villa Air"
  VQ = "Novoair"
  VR = "Tacv Cabo Verde Airlines"
  VS = "Virgin Atlantic"
  VT = "Air Tahiti"
  VU = "Vuelos Economicos"
  VV = "Viva Airlines Peru"
  VW = "Aeromar"
  VX = "Virgin America"
  VY = "Vueling"
  VZ = "Thai Vietjet Air"
  W1 = "WorldTicket"
  W2 = "Flexflight"
  W3 = "Arik Air"
  W4 = "LC Péru"
  W5 = "Mahan Airlines"
  W6 = "Wizz Air"
  W7 = "Sayakhat Airlines"
  W8 = "Caribbean Winds Airlines"
  W9 = "Wizz Air"
  WA = "KLM Cityhopper"
  WB = "Rwandair"
  WC = "Islena Airlines"
  WD = "Amsterdam Airlines Bv"
  WE = "Thai Smile Airways"
  WF = "Widerøe"
  WG = "Sunwing Airlines"
  WH = "West African Airlines"
  WI = "White Airways"
  WJ = "Air Labrador"
  WK = "Edelweiss Air"
  WL = "European Coastal Airlines"
  WM = "Windward Island Airways"
  WN = "Southwest Airlines"
  WO = "World Airways"
  WP = "Island Air"
  WQ = "Romavia"
  WR = "WestJet Encore"
  WS = "WestJet"
  WT = "Swiftair"
  WU = "Tikal Jets Airlines"
  WV = "Aero VIP"
  WW = "Wow Air"
  WX = "CityJet"
  WY = "Oman Air"
  WZ = "Red Wings Airlines"
  X1 = "Hahn Air Technologies"
  X3 = "TUIfly"
  X4 = "Air Excursions"
  X6 = "Airlines Reporting Corp"
  X7 = "Challenge Aero"
  X9 = "Avion Express"
  XB = "IATA"
  XC = "Corendon Airlines"
  XD = "Scheduled Airlines Traffic Offices"
  XE = "Delux Public Charter"
  XF = "Vladivostok Air"
  XG = "Sun Express Germany"
  XH = "Non Iata Codeshare Carrier"
  XJ = "Thai AirAsia X"
  XK = "Air Corsica"
  XL = "LATAM Ecuador"
  XM = "Zimex Aviation"
  XN = "XpressAir"
  XO = "Seair"
  XP = "Xtra Airways"
  XQ = "SunExpress"
  XR = "Corendon Airlines Europe"
  XS = "SITA"
  XT = "Indonesia AirAsia X"
  XU = "African Express Airways"
  XW = "NokScoot"
  XY = "Flynas"
  XZ = "South African Express"
  Y0 = "Yellow Airtaxi"
  Y1 = "Travel Technology Interactive"
  Y2 = "Air Century, S.A."
  Y3 = "Gryphon Airlines"
  Y4 = "Volaris"
  Y5 = "Golden Myanmar Airlines"
  Y6 = "AB Aviation"
  Y7 = "NordStar"
  Y8 = "Yangtze River Express"
  Y9 = "Kish Airlines"
  YA = "Nego Airline One"
  YB = "Harbour Air Seaplanes"
  YC = "Yamal Airlines"
  YD = "Mauritania Airways"
  YE = "Yan Air"
  YG = "South Airlines"
  YH = "Yangon Airways"
  YI = "Yunnan Yingan Airline"
  YJ = "Asian Wings Airways"
  YK = "Avia Traffic Company"
  YL = "Libyan Wings"
  YM = "Montenegro Airlines"
  YN = "Air Creebec"
  YO = "Heli Air Monaco"
  YP = "Perimeter Aviation"
  YQ = "TAR Aerolíneas"
  YR = "Scenic Airlines"
  YS = "Regional"
  YT = "Yeti Airlines"
  YU = "Euroatlantic Airways"
  YV = "Mesa Airlines"
  YW = "Air Nostrum"
  YX = "Republic Airline"
  YZ = "Alas Uruguay"
  Z2 = "AirAsia Zest"
  Z3 = "PM Air"
  Z4 = "Zagrosjet"
  Z5 = "GMG Airlines"
  Z6 = "Dniproavia"
  Z7 = "Amaszonas Uruguay"
  Z8 = "Línea Aérea Amaszonas"
  Z9 = "Jsc Bek Air"
  ZA = "Sky Angkor Airlines"
  ZB = "Monarch Airlines"
  ZC = "Fly Africa Zimbabwe"
  ZD = "Ewa Air"
  ZE = "Eastar Jet"
  ZF = "Azur Air"
  ZG = "Groznyy Avia"
  ZH = "Shenzhen Airlines"
  ZI = "Aigle Azur"
  ZJ = "Zambezi Airlines"
  ZK = "Great Lakes Airlines"
  ZL = "Regional Express"
  ZM = "Pegasus Asia"
  ZN = "Naysa"
  ZP = "Paranair"
  ZQ = "Azman Air"
  ZR = "Punto Azul"
  ZS = "Kazaviaspas"
  ZT = "Titan Airways"
  ZU = "Sunair"
  ZV = "V Air"
  ZW = "Air Wisconsin"
  ZX = "Air Georgian"
  ZY = "China Air Cargo"
  ZZ = "Airline Service"
  _0B = "Blue Air"
  _0C = "Catovair"
  _0J = "Premium Jet AG"
  _0O = "STA Travel"
  _0P = "Palau Pacific Airways"
  _0V = "Vietnam Air Services Company"
  _0W = "W Caribbean Costa Rica"
  _1A = "Amadeus"
  _1B = "Abacus"
  _1C = "EDS Information Business"
  _1D = "Raddix Solutions"
  _1E = "Travelsky Technology"
  _1F = "Infini Travel Information"
  _1G = "Travelport Galileo"
  _1H = "Sirena Travel"
  _1I = "Netjets Aviation"
  _1J = "Axess International"
  _1K = "Sutra"
  _1L = "Navitaire Open Skies"
  _1M = "Sirena Jsc"
  _1N = "Navitaire New Skies"
  _1O = "Phoenix Systems Dertours"
  _1P = "Travelport Worldspan"
  _1Q = "Joint Stock Company Ital"
  _1R = "Bird Information Systems"
  _1S = "Sabre"
  _1T = "East Line"
  _1U = "ITA Software"
  _1V = "Galileo International"
  _1W = "Sabre"
  _1X = "Branson Air Express"
  _1Y = "Electronic Data Systems (EDS)"
  _1Z = "Fantasia Info Network"
  _2A = "Deutsche Bahn"
  _2B = "Albawings"
  _2C = "SNCF"
  _2D = "Eastern Airlines, LLC"
  _2E = "Smokey Bay Air"
  _2F = "Fair Aviation"
  _2G = "Angara Airlines"
  _2H = "Thalys"
  _2I = "Star Perú"
  _2J = "Air Burkina"
  _2K = "Aerolineas Galapagos"
  _2L = "Helvetic Airways"
  _2M = "Maya Island Air"
  _2N = "Nextjet"
  _2O = "Redemption"
  _2P = "PAL Express"
  _2Q = "Air Cargo Carriers"
  _2R = "VIA Rail Canada"
  _2S = "Air Carnival"
  _2T = "Timbis Air"
  _2U = "Ero Sun d'Or"
  _2V = "Amtrak"
  _2W = "World 2 Fly, S.L"
  _2Z = "Passaredo Transportes"
  _3A = "Chu Kong Passenger Transport"
  _3B = "Job Air"
  _3C = "Air Chathams"
  _3D = "Dokasch"
  _3E = "Multi Aero"
  _3F = "Pacific Airways"
  _3G = "AsiaCargo Express"
  _3H = "Air Inuit"
  _3I = "Pison Airways Ltd"
  _3J = "Jubba Airways Kenya"
  _3K = "Jetstar Asia Airways"
  _3L = "Air Arabia Abu Dhabi"
  _3M = "Silver Airways"
  _3N = "Air Urga"
  _3O = "Air Arabia Maroc"
  _3P = "World 2 Fly Portugal"
  _3Q = "Carib Aviation Limited"
  _3R = "Divi Divi Air"
  _3S = "Air Antilles Express"
  _3T = "Tarco Air"
  _3U = "Sichuan Airlines"
  _3V = "Tnt Airways"
  _3W = "Malawian Airlines"
  _3X = "Premier Trans Aire"
  _3Z = "Travel Service Polska"
  _4A = "Aero Transporte"
  _4B = "Aviastar TU"
  _4C = "LATAM Colombia"
  _4D = "Air Sinai"
  _4E = "Tanana Air Service"
  _4F = "Freedom Airline Express"
  _4G = "Gazpromavia"
  _4H = "United Airways Bangladesh"
  _4I = "Ihy Izmir Havayollari"
  _4J = "Flydamas Airlines"
  _4K = "Air Askari Aviation"
  _4L = "Palau National Airlines"
  _4M = "LATAM Argentina"
  _4N = "Air North"
  _4O = "Interjet"
  _4P = "Travel Air"
  _4Q = "Safi Airways"
  _4R = "Star East Airline"
  _4S = "Star Airways"
  _4T = "Belair Airlines"
  _4U = "Germanwings"
  _4V = "Lacbravo"
  _4W = "Warbelows Air Ventures"
  _4X = "Atlantic Express Airline"
  _4Y = "Discover Airlines"
  _4Z = "Airlink"
  _5B = "Bassaka Air"
  _5C = "Challenge Aero"
  _5D = "Aeroméxico Connect"
  _5E = "Aero"
  _5F = "Fly One"
  _5H = "Five Fourty Aviation"
  _5I = "ALSA"
  _5J = "Cebu Pacific"
  _5K = "Hi Fly"
  _5L = "Fly Salone"
  _5M = "Montserrat Airways"
  _5N = "Jsc Nordavia"
  _5O = "ASL Airlines France"
  _5P = "PAL Airlines"
  _5R = "RUTACA Airlines"
  _5S = "Servicios Aereos Profesionales"
  _5T = "Canadian North"
  _5U = "Transportes Aéreos Guatemaltecos"
  _5V = "Everts"
  _5W = "WESTBahn"
  _5X = "UPS Airlines"
  _5Y = "Atlas Air"
  _5Z = "CemAir"
  _6A = "Armenia Airways"
  _6B = "Tuifly Nordic"
  _6C = "Air Timor"
  _6D = "Travel Service Slovensko"
  _6E = "IndiGo"
  _6F = "Primera Air Nordic"
  _6G = "Executive Express Aviation"
  _6H = "Israir Airlines"
  _6I = "Air Alsie"
  _6J = "Solaseed Air"
  _6K = "Songbird Airways"
  _6L = "Aklak Air"
  _6M = "Air Minas Linhas Aereas"
  _6N = "Niger Airlines"
  _6O = "Orbest"
  _6Q = "Cham Wings Airlines"
  _6R = "ALROSA"
  _6S = "Saudi Gulf Airlines"
  _6T = "Air Mandalay"
  _6V = "Avanza"
  _6W = "Saratov Airlines"
  _6Y = "SmartLynx Airlines"
  _6Z = "Eurasia Air"
  _7A = "Express Air Cargo"
  _7B = "Fly Blue Crane"
  _7C = "Jeju Air"
  _7D = "MGC Aviation"
  _7E = "Sylt Air"
  _7F = "First Air"
  _7G = "StarFlyer"
  _7H = "Ravn Alaska"
  _7I = "Insel Air International"
  _7J = "Tajik Air"
  _7K = "Kogalymavia Airlines"
  _7L = "Aero Caribbean"
  _7M = "Mayair"
  _7N = "PAWA Dominicana"
  _7O = "Travel Service Hungary"
  _7P = "Air Panama"
  _7Q = "Elite Airways"
  _7R = "RusLine"
  _7S = "Ryan Air Services"
  _7T = "Trenitalia"
  _7U = "Alpha Air Transport"
  _7V = "Federal Airlines"
  _7W = "Wind Rose Aviation"
  _7Y = "Mann Yadanarpon Airlines"
  _7Z = "Halcyon Air Cabo Verde"
  _8A = "Panama Airways"
  _8B = "TransNusa Air Services"
  _8C = "Air Transport International"
  _8D = "FitsAir"
  _8E = "Bering Air"
  _8F = "STP Airways"
  _8G = "Mid Africa Aviation"
  _8H = "BH Air"
  _8I = "Insel Air Aruba"
  _8J = "Línea Aerea Eco Jet"
  _8L = "Lucky Air"
  _8M = "Myanmar Airways International"
  _8N = "Regional Air Services"
  _8P = "Pacific Coastal Airlines"
  _8Q = "Onur Air"
  _8R = "Sol Líneas Aéreas"
  _8S = "Shun Tak China"
  _8T = "Air Tindi"
  _8U = "Afriqiyah Airways"
  _8V = "Astral Aviation"
  _8W = "Fly All Ways Airlines"
  _8Y = "Pan Pacific Airlines"
  _8Z = "Congo Airways"
  _9A = "Aladia Airlines"
  _9B = "AccesRail"
  _9C = "Spring Airlines"
  _9D = "Genghis Khan Airlines"
  _9E = "Endeavor Air"
  _9F = "Eurostar"
  _9G = "9G Rail"
  _9H = "Chang An Airlines"
  _9I = "Air India Regional"
  _9J = "Dana Air"
  _9K = "Cape Air"
  _9L = "West Link Airways"
  _9M = "Central Mountain Air"
  _9N = "Tropic Air"
  _9P = "Air Arabia Jordan"
  _9Q = "Caicos Express Airways"
  _9R = "SATENA"
  _9S = "Southern Air"
  _9T = "MyCargo Airlines"
  _9U = "Air Moldova"
  _9V = "Avior Airlines"
  _9W = "Jet Airways"
  _9X = "Southern Airways Express"
  _9Y = "National Airways"


class Airport(enum.Enum):
  AAA = "Anaa"
  AAB = "Arrabury Airport"
  AAC = "El Arish International Airport"
  AAD = "Adado"
  AAE = "Les Salines Airport"
  AAF = "Apalachicola Regional"
  AAG = "Arapoti"
  AAH = "Aachen/Merzbruck"
  AAI = "Arraias"
  AAJ = "Cayana Airstrip"
  AAK = "Aranuka"
  AAL = "Aalborg Airport"
  AAM = "Mala Mala"
  AAN = "Al Ain Airport"
  AAO = "Anaco"
  AAP = "Andrau Airpark"
  AAQ = "Anapa Airport"
  AAR = "Aarhus Airport"
  AAS = "Apalapsili"
  AAT = "Altay Airport"
  AAU = "Asau"
  AAV = "Allah Valley"
  AAW = "Abbottabad"
  AAX = "Araxa Airport"
  AAY = "Al Ghaydah"
  AAZ = "Quetzaltenango"
  ABA = "Abakan Airport"
  ABB = "Asaba International Airport"
  ABC = "Los Llanos"
  ABD = "Abadan Airport"
  ABE = "Lehigh Valley International Airport"
  ABF = "Abaiang"
  ABG = "Abingdon"
  ABH = "Alpha"
  ABI = "Abilene Regional Airport"
  ABJ = "Felix Houphouet Boigny Airport"
  ABK = "Kabri Dar"
  ABL = "Ambler Airport"
  ABM = "Northern Peninsula Airport"
  ABN = "Albina"
  ABO = "Aboisso"
  ABP = "Atkamba"
  ABQ = "Albuquerque International Sunport"
  ABR = "Aberdeen Municipal Airport"
  ABS = "Abu Simbel"
  ABT = "Al-Aqiq Airport"
  ABU = "Haliwen Airport"
  ABV = "Nnamdi Azikiwe International Airport"
  ABW = "Abau"
  ABX = "Albury Airport"
  ABY = "Southwest Georgia Regional Airport"
  ABZ = "Aberdeen International Airport"
  ACA = "Acapulco International Airport"
  ACB = "Antrim County"
  ACC = "Kotoka International Airport"
  ACD = "Acandi"
  ACE = "Lanzarote Airport"
  ACF = "Alaer Talimu Airport"
  ACH = "Altenrhein Airport"
  ACI = "Alderney Airport"
  ACJ = "Anuradhapura"
  ACK = "Nantucket Memorial Airport"
  ACL = "Aguaclara"
  ACM = "Arica"
  ACN = "International"
  ACP = "Sahand"
  ACR = "Araracuara"
  ACS = "Achinsk"
  ACT = "Waco Municipal Airport"
  ACU = "Achutupo"
  ACV = "Arcata-Eureka Airport"
  ACX = "Xingyi Airport"
  ACY = "Atlantic City International Airport"
  ACZ = "Zabol Airport"
  ADA = "Adana Airport"
  ADB = "Izmir Adnan Menderes Airport"
  ADC = "Andakombe"
  ADD = "Addis Ababa Bole International Airport"
  ADE = "International"
  ADF = "Adiyaman Airport"
  ADG = "Lenawee County"
  ADH = "Aldan"
  ADI = "Arandis"
  ADJ = "Marka International Airport"
  ADK = "Adak Island Ns"
  ADL = "Adelaide Airport"
  ADM = "Ardmore Municipal Airport"
  ADN = "Andes"
  ADO = "Andamooka"
  ADP = "Ampara"
  ADQ = "Kodiak Benny Benson State Airport"
  ADR = "Andrews"
  ADS = "Addison Airport"
  ADT = "Ada Municipal"
  ADU = "Ardabil Airport"
  ADV = "El Daein"
  ADW = "Andrews AFB"
  ADX = "Leuchars"
  ADY = "Alldays"
  ADZ = "Gustavo Rojas Pinilla Airport"
  AEA = "Abemama Atoll"
  AEB = "Youjiang"
  AED = "Aleneva"
  AEE = "Adareil Airport"
  AEG = "Aek Godang"
  AEH = "Abéché"
  AEI = "Algeciras"
  AEK = "Aseki"
  AEL = "Albert Lea"
  AEM = "Amgu"
  AEO = "Aioun El Atrouss"
  AEP = "Jorge Newbery Airport"
  AEQ = "Ar Horqin Airport"
  AER = "Sochi International Airport"
  AES = "Vigra Alesund Airport"
  AET = "Allakaket"
  AEU = "Abu Musa"
  AEX = "Alexandria International Airport"
  AEY = "Akureyri Airport"
  AFA = "San Rafael Airport"
  AFD = "Port Alfred"
  AFF = "USAF Academy Airstrip"
  AFI = "Amalfi"
  AFK = "Ampara Kondavattavan Tank Airport"
  AFL = "Alta Floresta Airport"
  AFN = "Municipal"
  AFO = "Municipal"
  AFR = "Afore"
  AFS = "Zarafshan"
  AFT = "Afutara Aerodrome"
  AFW = "Fort Worth Alliance Airport"
  AFY = "Afyon"
  AFZ = "Sabzevar"
  AGA = "Agadir Al Massira Airport"
  AGB = "Augsburg Airport"
  AGC = "Allegheny County Airport"
  AGD = "Anggi"
  AGE = "Flugplatz"
  AGF = "La Garenne Airport"
  AGG = "Angoram"
  AGH = "Angelholm Helsingborg Airport"
  AGI = "Wageningen"
  AGJ = "Aguni"
  AGK = "Kagua"
  AGL = "Wanigela"
  AGM = "Tasiilaq"
  AGN = "Angoon"
  AGO = "Municipal"
  AGP = "Malaga Airport"
  AGQ = "Agrinion"
  AGR = "Kheria"
  AGS = "Augusta Regional Airport"
  AGT = "Alejo Garcia Airport"
  AGU = "Aguascalients International Airport"
  AGV = "Acarigua"
  AGW = "Agnew"
  AGX = "Agatti Island Airport"
  AGZ = "Aggeneys"
  AHA = "Naha AFB"
  AHB = "Abha Regional Airport"
  AHC = "Amedee AAF"
  AHD = "Downtown"
  AHE = "Ahe Airport"
  AHF = "Municipal"
  AHH = "Municipal"
  AHI = "Amahai"
  AHJ = "Hongyuan Airport"
  AHL = "Aishalton"
  AHM = "Sumner Parker Field"
  AHN = "Athens-Ben Epps"
  AHO = "Alghero-Fertilia Airport"
  AHS = "Ahuas"
  AHT = "Amchitka"
  AHU = "Charif Al Idrissi Airport"
  AHW = "Saih Rawl"
  AHY = "Ambatolahy"
  AHZ = "Alpe D Huez"
  AIA = "Alliance Airport"
  AIC = "Airok"
  AID = "Municipal"
  AIE = "Aiome"
  AIF = "Assis"
  AIG = "Yalinga"
  AIH = "Aiambak"
  AII = "Alisabieh"
  AIK = "Municipal"
  AIL = "Ailigandi"
  AIM = "Ailuk Island"
  AIN = "Wainwright"
  AIO = "Municipal"
  AIP = "Ailinglapalap Island"
  AIR = "Aripuana"
  AIS = "Arorae Island"
  AIT = "Aitutaki Airport"
  AIU = "Atiu Island"
  AIV = "George Downer"
  AIW = "Ai-ais"
  AIY = "Bader Field"
  AIZ = "Lee C Fine Memorial"
  AJA = "Ajaccio Napoleon Bonaparte Airport"
  AJF = "Jouf Airport"
  AJI = "Agri Airport"
  AJJ = "Akjoujt"
  AJK = "Araak"
  AJL = "Aizawl Airport"
  AJN = "Ouani"
  AJR = "Arvidsjaur Airport"
  AJS = "Abreojos"
  AJU = "Aracaju Airport"
  AJY = "Agades"
  AKA = "Ankang"
  AKB = "Atka"
  AKC = "Fulton International"
  AKD = "Akola"
  AKE = "Akieni"
  AKF = "Kufrah"
  AKG = "Anguganak"
  AKH = "Prince Sultan Air Base"
  AKI = "Akiak"
  AKJ = "Asahikawa Airport"
  AKK = "Akhiok SPB"
  AKL = "Auckland Airport"
  AKM = "Zakouma"
  AKN = "King Salmon Airport"
  AKO = "Colorado Plains Regional Airport"
  AKP = "Anaktuvuk"
  AKQ = "Gunung Batin"
  AKR = "Akure"
  AKS = "Gwaunaru'u"
  AKT = "Raf Akrotiri"
  AKU = "Aksu Airport"
  AKV = "Akulivik"
  AKW = "Aghajari"
  AKX = "Aktyubinsk Airport"
  AKY = "Civil Airport"
  ALA = "Almaty Airport"
  ALB = "Albany International Airport"
  ALC = "Alicante-Elche Airport"
  ALD = "Alerta"
  ALE = "Alpine"
  ALF = "Alta Airport"
  ALG = "Houari Boumediene Airport"
  ALH = "Albany Airport"
  ALI = "International"
  ALJ = "Alexander Bay Airport"
  ALK = "Asela"
  ALL = "Albenga"
  ALM = "Municipal"
  ALN = "Alton"
  ALO = "Waterloo Airport"
  ALP = "Nejrab"
  ALQ = "Federal"
  ALR = "Alexandra"
  ALS = "Alamosa Municipal Airport"
  ALT = "Alenquer"
  ALU = "Alula"
  ALW = "Walla Walla Airport"
  ALX = "Thomas C Russell Field"
  ALY = "El Nohza"
  ALZ = "Alitak SPB"
  AMA = "Rick Husband Amarillo International Airport"
  AMB = "Ambilobe"
  AMC = "Am Timan"
  AMD = "Ahmedabad Airport"
  AME = "Alto Molocue"
  AMF = "Ama"
  AMG = "Amboin"
  AMH = "Arba Mintch Airport"
  AMI = "Selaparang"
  AMJ = "Almenara"
  AMK = "Animas Airpark"
  AML = "Puerto Armuellas"
  AMM = "Queen Alia International Airport"
  AMN = "Gratiot Community"
  AMO = "Mao"
  AMP = "Ampanihy"
  AMQ = "Pattimura Airport"
  AMR = "Arno"
  AMS = "Amsterdam Airport Schiphol"
  AMT = "Amata"
  AMU = "Amanab"
  AMV = "Amderma"
  AMW = "Ames"
  AMX = "Ammaroo"
  AMY = "Ambatomainty"
  AMZ = "Ardmore"
  ANA = "John Wayne International"
  ANB = "Anniston Metropolitan"
  ANC = "Ted Stevens Anchorage International Airport"
  AND = "Anderson"
  ANE = "Angers-Marce Airport"
  ANF = "Cerro Moreno International Airport"
  ANG = "Brie-Champniers"
  ANH = "Anuha Island Resort"
  ANI = "Aniak Airport"
  ANJ = "Zanaga"
  ANK = "Etimesgut"
  ANL = "Andulo"
  ANM = "Antsirabato"
  ANN = "Annette Island"
  ANO = "Angoche"
  ANP = "Lee"
  ANQ = "Tri-State Steuben County"
  ANR = "Antwerp International Airport"
  ANS = "Andahuaylas"
  ANT = "St Anton"
  ANU = "V.C. Bird International Airport"
  ANV = "Anvik Airport"
  ANW = "Ainsworth"
  ANX = "Andenes Airport"
  ANY = "Anthony"
  ANZ = "Angus Downs"
  AOA = "Aroa"
  AOB = "Annanberg"
  AOC = "Altenburg Nobitz"
  AOD = "Abou Deia"
  AOE = "Anadolu University"
  AOG = "Anshan Teng'ao Airport"
  AOH = "Allen County"
  AOI = "Ancona Falconara Airport"
  AOJ = "Aomori Airport"
  AOK = "Karpathos Airport"
  AOL = "Paso De Los Libres"
  AOM = "Adam Airport"
  AON = "Arona"
  AOO = "Altoona Airport"
  AOP = "Alferez FAP Alfredo Vladimir Sara Bauer Airport"
  AOR = "Sultan Abdul Halim Airport"
  AOS = "Amook"
  AOT = "Corrado Gex"
  AOU = "Attopeu"
  APA = "Centennial Airport"
  APB = "Apolo"
  APC = "Napa County"
  APE = "San Juan Aposento"
  APF = "Naples Municipal Airport"
  APG = "Phillips AAF"
  APH = "Camp A P Hill"
  API = "Apiay"
  APK = "Apataki"
  APL = "Nampula Airport"
  APN = "Alpena County Regional Airport"
  APO = "Apartado Airport"
  APP = "Asapa"
  APQ = "Arapiraca"
  APR = "April River"
  APS = "Anapolis"
  APT = "Marion County"
  APU = "Apucarana"
  APV = "Apple Valley"
  APW = "Faleolo Airport"
  APX = "Arapongas"
  APY = "Alto Parnaiba"
  APZ = "Zapala"
  AQA = "Araraquara"
  AQB = "Quiche Airport"
  AQG = "Anqing Tianzhushan Airport"
  AQI = "Qaisumah Airport"
  AQJ = "King Hussein International Airport"
  AQM = "Ariquemes"
  AQP = "Rodriguez Ballon International Airport"
  AQS = "Saqani"
  AQY = "Alyeska"
  ARA = "Acadiana Regional"
  ARB = "Municipal"
  ARC = "Arctic Village"
  ARD = "Alor Island Airport"
  ARE = "Arecibo"
  ARF = "Acaricuara"
  ARG = "Walnut Ridge"
  ARH = "Talagi Airport"
  ARI = "Chacalluta Airport"
  ARJ = "Arso"
  ARK = "Arusha Airport"
  ARL = "Arly"
  ARM = "Armidale Airport"
  ARN = "Stockholm Arlanda Airport"
  ARO = "Arboletas"
  ARP = "Aragip"
  ARQ = "Arauquita"
  ARR = "Alto Rio Senguerr"
  ARS = "Aragarcas"
  ART = "Watertown Airport"
  ARU = "Aracatuba Airport"
  ARV = "Noble F. Lee"
  ARW = "Arad"
  ARX = "Asbury Park"
  ARY = "Ararat"
  ARZ = "N'zeto"
  ASA = "Assab International"
  ASB = "Ashgabat Airport"
  ASC = "Ascension"
  ASD = "Andros Town"
  ASE = "Aspen Airport"
  ASF = "Astrakhan Airport"
  ASG = "Ashburton"
  ASH = "Boire Field"
  ASI = "Saint Helena Airport"
  ASJ = "Amami Airport"
  ASK = "Yamoussoukro"
  ASL = "Harrison County"
  ASM = "Asmara International Airport"
  ASN = "Talladega"
  ASO = "Asosa Airport"
  ASP = "Alice Springs Airport"
  ASQ = "Austin"
  ASR = "Kayseri Airport"
  ASS = "Arathusa Safari Lodge"
  AST = "Astoria"
  ASU = "Silvio Pettirossi International Airport"
  ASV = "Amboseli"
  ASW = "Aswan Airport"
  ASX = "Ashland"
  ASY = "Ashley"
  ASZ = "Asirim"
  ATA = "Anta"
  ATB = "Atbara"
  ATC = "Arthur's Town"
  ATD = "Atoifi"
  ATE = "Antlers"
  ATF = "Chachoan"
  ATG = "Attock"
  ATH = "Eleftherios Venizelos International Airport"
  ATI = "Artigas"
  ATJ = "Antsirabe"
  ATK = "Atqasuk Edward Burnell Sr. Memorial Airport"
  ATL = "Hartsfield-Jackson Atlanta International Airport"
  ATM = "Altamira Airport"
  ATN = "Namatanai"
  ATO = "Ohio University"
  ATP = "Airstrip"
  ATQ = "Sri Guru Ram Dass Jee International Airport"
  ATR = "Mouakchott"
  ATS = "Artesia"
  ATT = "Atmautluak Airport"
  ATU = "Casco Cove"
  ATV = "Ati"
  ATW = "Outagamie County Regional Airport"
  ATX = "Atbasar"
  ATY = "Watertown Airport"
  ATZ = "Assiut Airport"
  AUA = "Reina Beatrix International Airport"
  AUB = "Itauba Airport"
  AUC = "Arauca Airport"
  AUD = "Augustus Downs"
  AUE = "Abu Rudeis"
  AUF = "Auxerre Branches"
  AUG = "Augusta Airport"
  AUH = "Abu Dhabi International Airport"
  AUI = "Aua Island"
  AUJ = "Ambunti"
  AUK = "Alakanuk Airport"
  AUL = "Aur Island"
  AUM = "Austin"
  AUN = "Auburn"
  AUO = "Auburn-Opelika"
  AUP = "Agaun"
  AUQ = "Hiva Oa Airport"
  AUR = "Aurillac Airport"
  AUS = "Austin-Bergstrom International Airport"
  AUT = "Atauro"
  AUU = "Aurukun Mission"
  AUV = "Aumo"
  AUW = "Municipal"
  AUX = "Araguaina Airport"
  AUY = "Aneityum"
  AUZ = "Municipal Airport"
  AVA = "An Shun/Huang Guo Shu Airport"
  AVB = "Aviano"
  AVG = "Auvergne"
  AVI = "Maximo Gomez"
  AVK = "Arvaikheer"
  AVL = "Asheville Regional Airport"
  AVN = "Avignon-Caumont Airport"
  AVO = "Municipal"
  AVP = "Wilkes-Barre/Scranton International Airport"
  AVR = "Alverca"
  AVU = "Avu Avu"
  AVV = "Avalon Airport"
  AVW = "Avra Valley"
  AVX = "Avalon Bay"
  AWA = "Awassa"
  AWB = "Awaba Airport"
  AWD = "Aniwa"
  AWE = "Alowe"
  AWK = "Wake Island"
  AWM = "Municipal"
  AWN = "Alton Downs"
  AWP = "Austral Downs Airport"
  AWR = "Awar"
  AWZ = "Ahwaz Airport"
  AXA = "Clayton J. Lloyd International Airport"
  AXB = "Alexandria Bay"
  AXC = "Aramac"
  AXD = "Demokritos Airport"
  AXE = "Xanxere"
  AXF = "Alxa Left Banner"
  AXG = "Algona"
  AXJ = "Amakusa"
  AXK = "Ataq"
  AXL = "Alexandria"
  AXM = "El Eden Airport"
  AXN = "Alexandria"
  AXO = "Bandar Udara Pantar"
  AXP = "Springpoint Airport"
  AXR = "Arutua Airport"
  AXS = "Municipal"
  AXT = "Akita Airport"
  AXU = "Axum Airport"
  AXV = "Neil Armstrong"
  AXX = "Angel Fire"
  AYA = "Ayapel"
  AYC = "Ayacucho"
  AYD = "Alroy Downs"
  AYE = "AAF Heliport"
  AYG = "Yaguara"
  AYI = "Yari"
  AYK = "Arkalyk"
  AYL = "Anthony Lagoon"
  AYM = "Yas Island SPB"
  AYN = "Anyang Airport"
  AYO = "Ayolas"
  AYP = "Yanamilla Airport"
  AYQ = "Connellan Airport"
  AYR = "Ayr"
  AYS = "Ware County"
  AYT = "Antalya Airport"
  AYU = "Aiyura"
  AYW = "Ayawasi"
  AYX = "Gerardo Pérez Pinedo"
  AYY = "Arugam Bay SPB"
  AYZ = "Zahns"
  AZA = "Phoenix-Mesa Gateway Airport"
  AZB = "Amazon Bay"
  AZD = "Yazd Airport"
  AZG = "Apatzingan"
  AZI = "Bateen"
  AZJ = "Zhenjiang Dalu"
  AZL = "Fazenda Tucunare Airport"
  AZN = "Andizhan Airport"
  AZO = "Kalamazoo Battle Creek International Airport"
  AZP = "Atizapan"
  AZR = "Adrar Airport"
  AZS = "Samaná El Catey International"
  AZT = "Zapatoca"
  AZZ = "Ambriz"
  BAA = "Bialla"
  BAB = "Beale AFB"
  BAC = "Barranca De Upia"
  BAD = "Barksdale AFB"
  BAE = "Barcelonnette"
  BAF = "Barnes"
  BAG = "Loakan"
  BAH = "Bahrain International Airport"
  BAI = "Buenos Aires"
  BAJ = "Bali"
  BAL = "Batman Airport"
  BAM = "Lander County"
  BAN = "Basongo"
  BAO = "Udorn"
  BAP = "Baibara"
  BAQ = "E Cortissoz Airport"
  BAR = "Baker AAF"
  BAS = "Balalae"
  BAT = "Airport Chafei Amsei"
  BAU = "Bauru Airport"
  BAV = "Baotou Airport"
  BAW = "Biawonque"
  BAX = "Barnaul Gherman Titov International Airport"
  BAY = "Baia Mare"
  BAZ = "Barbelos"
  BBA = "Teniente Vidal Airport"
  BBB = "Benson Municipal Airport"
  BBC = "Bay City"
  BBD = "Curtis Field"
  BBF = "Burlington"
  BBG = "Butaritari"
  BBH = "Barth"
  BBI = "Biju Patnaik International Airport"
  BBJ = "Bitburg Air Base"
  BBK = "Kasane Airport"
  BBL = "Ballera Airport"
  BBM = "Battambang"
  BBN = "Bario Airport"
  BBO = "Berbera"
  BBP = "Bembridge"
  BBQ = "Barbuda"
  BBR = "Baillif"
  BBS = "Blackbushe"
  BBT = "Berberati"
  BBU = "Baneasa"
  BBV = "Hkg"
  BBW = "Broken Bow"
  BBX = "Wings Field"
  BBY = "Bambari"
  BBZ = "Zambezi"
  BCA = "Baracoa"
  BCB = "Virginia Tech"
  BCC = "Bear Creek"
  BCD = "Bacolod-Silay International Airport"
  BCE = "Bryce"
  BCF = "Bouca"
  BCG = "Bemichi"
  BCH = "Cakung International"
  BCI = "Barcaldine Airport"
  BCJ = "Baca Grande"
  BCK = "Bolwarra"
  BCL = "Barra Colorado"
  BCM = "Bacau Airport"
  BCN = "Barcelona-El Prat Airport"
  BCO = "Jinka"
  BCP = "Bambu"
  BCQ = "Brack"
  BCR = "Boca Do Acre"
  BCS = "Southern Seaplane"
  BCT = "Public"
  BCU = "Bauchi"
  BCV = "Belmopan"
  BCW = "Benguera Island"
  BCX = "Beloreck"
  BCY = "Bulchi"
  BCZ = "Bickerton Island"
  BDA = "L.F. Wade International Airport"
  BDB = "Bundaberg Airport"
  BDC = "Barra Do Corda"
  BDD = "Badu Island"
  BDE = "Baudette"
  BDF = "Rinkenberger"
  BDG = "Blanding"
  BDH = "Bandar Lengeh"
  BDI = "Bird Island"
  BDJ = "Syamsudin Noor International Airport"
  BDK = "Bondoukou"
  BDL = "Bradley International Airport"
  BDM = "Bandirma"
  BDN = "Talhar"
  BDO = "Husein Sastranegara Airport"
  BDP = "Bhadrapur Airport"
  BDQ = "Vadodara Airport"
  BDR = "Igor I. Sikorsky Memorial"
  BDS = "Brindisi - Salento Airport"
  BDT = "Gbadolite"
  BDU = "Bardufoss Airport"
  BDV = "Moba"
  BDW = "Bedford Downs"
  BDX = "Broadus"
  BDY = "State"
  BDZ = "Baindoung"
  BEA = "Bereina"
  BEB = "Benbecula Airport"
  BEC = "Beech"
  BED = "Hanscom Field"
  BEE = "Beagle Bay"
  BEF = "Bluefields"
  BEG = "Belgrad Nikola Tesla Airport"
  BEH = "Ross Field"
  BEI = "Beica"
  BEJ = "Kalimarau Airport"
  BEK = "Bareli"
  BEL = "Val De Cans International Airport"
  BEM = "Beni Mellal Airport"
  BEN = "Benina International"
  BEO = "Belmont"
  BEP = "Bellary"
  BEQ = "Honington"
  BER = "Berlin Brandenburg Airport"
  BES = "Brest Bretagne Airport"
  BET = "Bethel Airport"
  BEU = "Bedourie"
  BEV = "Beer Sheba"
  BEW = "Beira Airport"
  BEX = "Benson RAF Station"
  BEY = "Beirut-Rafic Hariri International Airport"
  BEZ = "Beru"
  BFA = "Bahia Negra"
  BFB = "Blue Fox Bay"
  BFC = "Bloomfield"
  BFD = "Bradford Airport"
  BFE = "Bielefeld"
  BFF = "Western Nebraska Regional Airport"
  BFG = "Bullfrog Basin"
  BFH = "Bacacheri"
  BFI = "Boeing Field International Airport"
  BFJ = "Bijie Airport"
  BFK = "Buffalo Municipal Airport"
  BFL = "Meadows Field Airport"
  BFM = "Mobile Downtown Airport"
  BFN = "Bram Fischer International Airport"
  BFO = "Buffalo Range"
  BFP = "Beaver Falls"
  BFQ = "Bahia Pinas"
  BFR = "Virgil I Grissom Municipalcipal"
  BFS = "Belfast International Airport"
  BFT = "County"
  BFU = "Bengbu"
  BFV = "Buri Ram Airport"
  BFW = "Sidi Belabbes"
  BFX = "Bafoussam"
  BGA = "Palonegro International Airport"
  BGB = "Booue"
  BGC = "Braganca Airport"
  BGD = "Borger"
  BGE = "Decatur County"
  BGF = "Bangui Airport"
  BGG = "Bingol Airport"
  BGH = "Abbaye"
  BGI = "Grantley Adams International Airport"
  BGJ = "Borgarfjordur Eystri"
  BGK = "Big Creek"
  BGL = "Baglung"
  BGM = "Greater Binghamton Airport"
  BGN = "Belaya Gora Airport"
  BGO = "Bergen Airport"
  BGP = "Bongo"
  BGQ = "Big Lake"
  BGR = "Bangor International Airport"
  BGS = "Webb AFB"
  BGT = "Bagdad"
  BGU = "Bangassou"
  BGV = "Bento Goncalves"
  BGW = "Baghdad International Airport"
  BGX = "Airport Cmdt. Gustavo Kraemer"
  BGY = "Orio al Serio International Airport"
  BGZ = "Braga"
  BHA = "Bahia De Caraquez"
  BHB = "Bar Harbor Airport"
  BHC = "Bhurban Heliport"
  BHD = "George Best Belfast City Airport"
  BHE = "Woodbourne Airport"
  BHF = "Bahia Cupica"
  BHG = "Brus Laguna"
  BHH = "Bisha Airport"
  BHI = "Comandante Airport"
  BHJ = "Rudra Mata Airport"
  BHK = "Bukhara Airport"
  BHL = "Bahia Angeles"
  BHM = "Birmingham-Shuttlesworth International Airport"
  BHN = "Beihan"
  BHO = "Raja Bhoj Airport"
  BHP = "Bhojpur"
  BHQ = "Broken Hill Airport"
  BHR = "Bharatpur Airport"
  BHS = "Raglan Airport"
  BHT = "Brighton Downs"
  BHU = "Bhavnagar Airport"
  BHV = "Bahawalpur Airport"
  BHW = "Bhagatanwala Airport"
  BHX = "Birmingham International Airport"
  BHY = "Beihai Fucheng Airport"
  BIA = "Bastia Poretta Airport"
  BIB = "Baidoa"
  BIC = "Aérodrome de Belle Île"
  BID = "Block Island"
  BIE = "Beatrice"
  BIF = "Biggs AAF"
  BIG = "Intermediate Field"
  BIH = "Bishop"
  BII = "Enyu Airfield"
  BIJ = "Biliau"
  BIK = "Mokmer Airport"
  BIL = "Billings Logan International Airport"
  BIM = "Bimini International Airport"
  BIN = "Bamiyan"
  BIO = "Bilbao Airport"
  BIP = "Bulimba"
  BIQ = "Biarritz - Anglet - Bayonne Airport"
  BIR = "Biratnagar Airport"
  BIS = "Bismarck Airport"
  BIT = "Baitadi"
  BIU = "Bildudalur"
  BIV = "Bria"
  BIW = "Billiluna"
  BIX = "Keesler AFB"
  BIY = "Bisho"
  BIZ = "Bimin"
  BJA = "Bejaia Airport"
  BJB = "Bojnord"
  BJC = "Jeffco"
  BJD = "Bakkafjordur"
  BJE = "Baleela"
  BJF = "Batsfjord Airport"
  BJG = "Bolaang"
  BJH = "Bajhang"
  BJI = "Bemidji Airport"
  BJJ = "Wayne County"
  BJK = "Benjina"
  BJL = "Yundum International Airport"
  BJM = "Bujumbura International Airport"
  BJN = "Bajone"
  BJO = "Bermejo"
  BJP = "Braganca Paulista"
  BJQ = "Bahja Airport"
  BJR = "Bahar Dar Airport"
  BJT = "Bentota River"
  BJU = "Bajura Airport"
  BJV = "Milas-Bodrum Airport"
  BJW = "Bajawa Soa Airport"
  BJX = "Guanajuato International Airport"
  BJY = "Batajnica"
  BJZ = "Badajoz Airport"
  BKA = "Bykovo"
  BKB = "Bikaner"
  BKC = "Buckland Airport"
  BKD = "Stephens County"
  BKE = "Baker"
  BKF = "Lake Brooks SPB"
  BKG = "Branson"
  BKH = "Barking Sands PMRF"
  BKI = "Kota Kinabalu International Airport"
  BKJ = "Boke"
  BKK = "Suvarnabhumi Airport"
  BKL = "Burke Lakefront Airport"
  BKM = "Bakalalan"
  BKN = "Balkanabat Airport"
  BKO = "Bamako-Senou International Airport"
  BKP = "Barkly Downs"
  BKQ = "Blackall Airport"
  BKR = "Bokoro"
  BKS = "Fatmawati Soekarno Airport"
  BKT = "Blackstone AAF"
  BKU = "Betioky"
  BKV = "Bailing Airport"
  BKW = "Beckley Airport"
  BKX = "Brookings"
  BKY = "Kavumu"
  BKZ = "Bukoba Airport"
  BLA = "General Jose Antonio Anzoategui International Airport"
  BLB = "Panama Pacifico Airport"
  BLC = "Bamenda"
  BLD = "Boulder City"
  BLE = "Dala Airport"
  BLF = "Princeton"
  BLG = "Belaga"
  BLH = "Blythe"
  BLI = "Bellingham International Airport"
  BLJ = "Batna Airport"
  BLK = "Blackpool Airport"
  BLL = "Billund Airport"
  BLM = "Monmouth Executive Airport"
  BLN = "Benalla"
  BLO = "Blonduos"
  BLP = "Bellavista"
  BLQ = "Guglielmo Marconi Airport"
  BLR = "Kempegowda International Airport"
  BLS = "Bollon"
  BLT = "Blackwater"
  BLU = "Blue Canyon"
  BLV = "Belleville"
  BLW = "Bellows Field"
  BLX = "Belluno"
  BLY = "Belmullet"
  BLZ = "Chileka Airport"
  BMA = "Bromma Airport"
  BMB = "Bumba"
  BMC = "Brigham City"
  BMD = "Belo"
  BME = "Broome Airport"
  BMF = "Bakouma"
  BMG = "Bloomington"
  BMH = "Bomai"
  BMI = "Central Illinois Regional Airport"
  BMJ = "Baramita"
  BMK = "Borkum"
  BML = "Berlin Municipal Airport"
  BMM = "Bitam"
  BMN = "Bamerny"
  BMO = "Bhamo"
  BMP = "Brampton Island"
  BMQ = "Bamburi"
  BMR = "Baltrum"
  BMS = "Brumado"
  BMT = "Beaumont Municipalcipal"
  BMU = "Sultan Muhammad Salahuddin Airport"
  BMV = "Phung-Duc Airport"
  BMW = "Bordj Badji Mokhtar"
  BMX = "Big Mountain"
  BMY = "Belep Island"
  BMZ = "Bamu"
  BNA = "Nashville International Airport"
  BNB = "Boende"
  BNC = "Beni"
  BND = "Bandar Abbas International Airport"
  BNE = "Brisbane Airport"
  BNF = "Warm Spring Bay SPB"
  BNG = "Banning"
  BNH = "Barnes"
  BNI = "Benin City Airport"
  BNK = "Ballina Byron Airport"
  BNL = "Barnwell Regional"
  BNM = "Bodinumu"
  BNN = "Bronnoysund Airport Bronnoy"
  BNO = "Burns"
  BNP = "Bannu"
  BNQ = "Baganga"
  BNR = "Banfora"
  BNS = "Barinas"
  BNT = "Bundi"
  BNU = "Blumenau"
  BNV = "Boana"
  BNW = "Boone"
  BNX = "Banja Luka Airport"
  BNY = "Bellona"
  BNZ = "Banz"
  BOA = "Boma"
  BOB = "Motu Mute Airport"
  BOC = "Bocas Del Toro"
  BOD = "Bordeaux Airport"
  BOE = "Boundji"
  BOF = "Bolling AFB"
  BOG = "El Dorado International Airport"
  BOH = "Bournemouth Airport"
  BOI = "Boise Air Terminal (Gowen Field)"
  BOJ = "Bourgas Airport"
  BOK = "Brookings State"
  BOL = "Ballykelly"
  BOM = "Chhatrapati Shivaji International Airport"
  BON = "Flamingo International Airport"
  BOO = "Bodo Airport"
  BOP = "Bouar"
  BOQ = "Boku"
  BOS = "Logan International Airport"
  BOT = "Boset"
  BOU = "Bourges"
  BOV = "Boang"
  BOW = "Bartow"
  BOX = "Borroloola"
  BOY = "Borgo"
  BOZ = "Bozoum"
  BPA = "Grumman"
  BPB = "Boridi"
  BPC = "Bamenda"
  BPD = "Bapi"
  BPE = "Qinhuangdao Beidaihe Airport"
  BPF = "Batuna Aerodrome"
  BPG = "Barra Do Garcas"
  BPH = "Bislig"
  BPI = "Big Piney-marbleton"
  BPK = "Biangabip"
  BPL = "Bole Airport"
  BPM = "Begumpet"
  BPN = "Sultan Aji Muhamad Sulaiman Airport"
  BPS = "Porto Seguro Airport"
  BPT = "Jefferson County Airport"
  BPU = "Beppu"
  BPX = "Bangda Airport"
  BPY = "Besalampy"
  BQA = "Baler"
  BQB = "Bussellton Regional Airport"
  BQE = "Bubaque"
  BQG = "Bogorodskoye"
  BQH = "Biggin Hill"
  BQI = "Bagani"
  BQJ = "Batagay"
  BQK = "Glynco Jetport"
  BQL = "Boulia"
  BQN = "Rafael Hernandez Airport"
  BQO = "Bouna"
  BQQ = "Barra"
  BQS = "Blagoveschensk Airport"
  BQT = "Brest Airport"
  BQU = "J. F. Mitchell"
  BQV = "Bartlett SPB"
  BQW = "Balgo Hills"
  BRA = "Barreiras Airport"
  BRB = "Barreirinhas"
  BRC = "San Carlos de Bariloche International Airport"
  BRD = "Crow Wing County Airport"
  BRE = "Bremen Airport"
  BRF = "Bradford"
  BRG = "Municipal"
  BRH = "Brahman"
  BRI = "Palese Airport"
  BRJ = "Bright"
  BRK = "Bourke"
  BRL = "Burlington Airport"
  BRM = "Barquisimeto Airport"
  BRN = "Bern Airport"
  BRO = "South Padre Island International Airport"
  BRP = "Biaru"
  BRQ = "Turany Airport"
  BRR = "North Bay Airport"
  BRS = "Bristol Airport"
  BRT = "Bathurst Island"
  BRU = "Brussels Airport"
  BRV = "Bremerhaven"
  BRW = "Wiley Post-Will Rogers Memorial Airport"
  BRX = "Barahona"
  BRY = "Samuels Field"
  BRZ = "Borotou"
  BSA = "Bossaso"
  BSB = "Brasilia International Airport"
  BSC = "Bahia Solano"
  BSD = "Baoshan Airport"
  BSE = "Sematan"
  BSF = "Bradshaw AAF"
  BSG = "Bata Airport"
  BSH = "Brighton"
  BSI = "Blairsville"
  BSJ = "Bairnsdale"
  BSK = "Biskra Airport"
  BSL = "EuroAirport Swiss"
  BSM = "Bishe-kola"
  BSN = "Bossangoa"
  BSO = "Basco Airport"
  BSP = "Bensbach"
  BSQ = "Bisbee Municipal Airport"
  BSR = "Basra International Airport"
  BSS = "Balsas"
  BST = "Bost"
  BSU = "Basankusu"
  BSV = "Besakoa"
  BSW = "Boswell Bay"
  BSX = "Bassein"
  BSY = "Bardera"
  BSZ = "Bartletts"
  BTA = "Yaoundé"
  BTB = "Betou"
  BTC = "Batticaloa"
  BTD = "Brunette Downs"
  BTE = "Bonthe"
  BTF = "Salt Lake Skypark"
  BTG = "Batangafo"
  BTH = "Hang Nadim International Airport"
  BTI = "Barter Island Airport"
  BTJ = "Sultan Iskandar Muda International Airport"
  BTK = "Bratsk Airport"
  BTL = "WK Kellogg Regional"
  BTM = "Butte Airport"
  BTN = "Bennettsville"
  BTO = "Botopasie"
  BTP = "Butler County - Kenny Scholter Field"
  BTQ = "Butare"
  BTR = "Baton Rouge Metropolitan Airport"
  BTS = "Bratislava Airport"
  BTT = "Bettles"
  BTU = "Bintulu Airport"
  BTV = "Burlington International Airport"
  BTW = "Batu Licin"
  BTX = "Betoota"
  BTY = "Beatty"
  BTZ = "Yala Betong International Airport"
  BUA = "Buka"
  BUB = "Municipal"
  BUC = "Burketown"
  BUD = "Budapest Ferenc Liszt International Airport"
  BUF = "Buffalo Niagara International Airport"
  BUG = "Gen V Deslandes"
  BUI = "Bokondini"
  BUJ = "Ain Eddis"
  BUK = "Albuq"
  BUL = "Bulolo"
  BUM = "Butler"
  BUN = "Buenaventura"
  BUO = "Burao"
  BUP = "Bhatinda Airport"
  BUQ = "Bulawayo Airport"
  BUR = "Bob Hope Airport"
  BUS = "Batumi Airport"
  BUT = "Bathpalathang Airport"
  BUU = "Muara Bungo Airport"
  BUV = "Bella Union"
  BUW = "Baubau Airport"
  BUX = "Bunia"
  BUY = "Bunbury"
  BUZ = "Bushehr Airport"
  BVA = "Beauvais-Tille Airport"
  BVB = "Boa Vista Airport"
  BVC = "Rabil Airport"
  BVD = "Sea Port"
  BVE = "Laroche Airport"
  BVF = "Dama"
  BVG = "Berlevag Airport"
  BVH = "Vilhena Airport"
  BVI = "Birdsville"
  BVJ = "Bovanenkovo Airport"
  BVK = "Huacaraje"
  BVL = "Baures"
  BVM = "Belmonte"
  BVO = "Bartlesville"
  BVP = "Bolovip"
  BVR = "Esperadinha"
  BVS = "Breves"
  BVU = "Beluga"
  BVV = "Burevestnik AFB"
  BVW = "Batavia Downs"
  BVX = "Municipal"
  BVY = "Beverly Municipal Airport"
  BVZ = "Beverley Springs"
  BWA = "Bhairawa Airport"
  BWB = "Barrow Island"
  BWC = "Brawley"
  BWD = "Brownwood"
  BWE = "Braunschweig"
  BWF = "Walney Island"
  BWG = "Warren County"
  BWH = "Butterworth"
  BWI = "Baltimore/Wash International Thurgood Marshall Airport"
  BWJ = "Bawan"
  BWK = "Brac"
  BWL = "Blackwell"
  BWM = "Bowman"
  BWN = "Brunei International Airport"
  BWO = "Balakovo"
  BWP = "Bewani"
  BWQ = "Brewarrina"
  BWS = "Blaine"
  BWT = "Burnie Wynyard Airport"
  BWU = "Sydney Bankstown"
  BWW = "Las Brujas Airport"
  BWX = "Bandar Udara Internasional Banyuwangi"
  BXA = "George R Carr"
  BXB = "Babo"
  BXC = "Boxborough"
  BXD = "Bade"
  BXE = "Bakel"
  BXF = "Belburn"
  BXG = "Bendigo"
  BXH = "Balhash"
  BXI = "Boundiali"
  BXJ = "Burundai"
  BXK = "Buckeye Municipal"
  BXL = "Blue Lagoon"
  BXM = "Batom"
  BXN = "Imsik"
  BXO = "Buochs"
  BXP = "Biala Podlaska"
  BXR = "Bam"
  BXS = "Borrego Springs"
  BXT = "Bontang"
  BXU = "Butuan Airport"
  BXV = "Breiddalsvik"
  BXW = "Harun Thohir Airport"
  BXX = "Borama International"
  BXY = "Baikonur Krayniy Airport"
  BXZ = "Bunsil"
  BYA = "Boundary"
  BYB = "Dibaa"
  BYC = "Yacuiba"
  BYD = "Beidah"
  BYF = "Albert-Bray Airport"
  BYG = "Municipal"
  BYH = "Blytheville AFB"
  BYI = "Rupert"
  BYJ = "Beja International"
  BYK = "Bouake"
  BYL = "Bella Yella"
  BYM = "C.M. de Cespedes"
  BYN = "Bayankhongor"
  BYO = "Bonito Airport"
  BYP = "Barimunya Airport"
  BYQ = "Bunyu"
  BYR = "Laeso Airport"
  BYS = "Bicycle Lake AAF"
  BYT = "Bantry"
  BYU = "Bindlacher-Berg"
  BYV = "Beira Lake SPB"
  BYW = "Blakely Island"
  BYX = "Baniyala"
  BZA = "San Pedro"
  BZB = "Bazaruto Island"
  BZC = "Buzios"
  BZD = "Balranald"
  BZE = "Philip S.W. Goldson International Airport"
  BZF = "Benton Field"
  BZG = "Bydgoszcz Airport"
  BZH = "Bumi Hills"
  BZI = "Balikesir"
  BZK = "Bryansk International Airport"
  BZL = "Barisal Airport"
  BZM = "Bemolanga Airport"
  BZN = "Bozeman Yellowstone International Airport"
  BZO = "Bolzano"
  BZP = "Bizant"
  BZR = "Beziers Vias Airport"
  BZS = "Buzzards Pt S"
  BZT = "Eagle Air Park"
  BZU = "Buta"
  BZV = "Maya Maya Airport"
  BZX = "Bazhong Enyang Airport"
  BZY = "Beltsy Airport"
  BZZ = "Raf Brize Norton"
  CAA = "Catacamas"
  CAB = "Cabinda Airport"
  CAC = "Cascavel Airport"
  CAD = "Cadillac"
  CAE = "Columbia Metropolitan Airport"
  CAF = "Carauari"
  CAG = "Cagliari Elmas Airport"
  CAH = "Kamau"
  CAI = "Cairo International Airport"
  CAJ = "Canaima"
  CAK = "Akron-Canton Airport"
  CAL = "Machrihanish Airport"
  CAM = "Camiri"
  CAN = "Guangzhou Baiyun International Airport"
  CAO = "Clayton"
  CAP = "Cap Haitien Airport"
  CAQ = "Caucasia"
  CAR = "Municipal"
  CAS = "Anfa"
  CAT = "Cascais Municipal Aerodrome"
  CAU = "Caruaru"
  CAV = "Cazombo"
  CAW = "Bartolomeu Lisandro Airport"
  CAX = "Carlisle"
  CAY = "Felix Eboue Airport"
  CAZ = "Cobar"
  CBA = "Corner Bay"
  CBB = "J Wilsterman Airport"
  CBC = "Cherrabun"
  CBD = "Car Nicobar"
  CBE = "Greater Cumberland Regional"
  CBF = "Municipal"
  CBG = "Cambridge Airport"
  CBH = "Leger"
  CBI = "Cape Barren Island"
  CBJ = "Cabo Rojo"
  CBK = "Municipal"
  CBL = "Ciudad Bolivar"
  CBM = "Columbus AFB"
  CBN = "Penggung"
  CBO = "Awang Airport"
  CBP = "Coimbra"
  CBQ = "Calabar Airport"
  CBR = "Canberra Airport"
  CBS = "Oro Negro"
  CBT = "Catumbela Airport"
  CBU = "Cottbus"
  CBV = "Coban"
  CBW = "Campo Mourao"
  CBX = "Condobolin"
  CBY = "Canobie"
  CBZ = "Cabin Creek"
  CCA = "Chaffee AFB"
  CCB = "Cable Airport"
  CCC = "Jardines del Rey Airport"
  CCD = "Century City"
  CCE = "Grand Case"
  CCF = "Carcassonne Airport"
  CCG = "Crane County Airport"
  CCH = "Chile Chico"
  CCI = "Concordia"
  CCJ = "Calicut International Airport"
  CCK = "Cocos Islands Airport"
  CCL = "Chinchilla"
  CCM = "Criciuma"
  CCN = "Chakcharan"
  CCO = "Carimagua"
  CCP = "Carriel Sur Airport"
  CCQ = "Cachoeira"
  CCR = "Buchanan Field"
  CCS = "Simon Bolivar International Airport"
  CCT = "Colonia Catriel"
  CCU = "Netaji Subhas Chandra Bose Airport"
  CCV = "Craig Cove"
  CCW = "Cowell"
  CCX = "Caceres"
  CCY = "Municipal"
  CCZ = "Chub Cay"
  CDA = "Cooinda"
  CDB = "Cold Bay Airport"
  CDC = "Cedar City Airport"
  CDD = "Cauquira"
  CDE = "Caledonia"
  CDG = "Charles de Gaulle Airport"
  CDH = "Harrell Field"
  CDI = "Cachoeiro Itapemirim"
  CDJ = "Conceicao Do Araguaia"
  CDK = "Lewis"
  CDL = "Candle"
  CDN = "Woodward Field"
  CDO = "Cradock"
  CDP = "Cuddapah"
  CDQ = "Croydon"
  CDR = "Chadron Airport"
  CDS = "Childress"
  CDT = "Castellon"
  CDU = "Camden"
  CDV = "Mudhole Smith Airport"
  CDW = "Caldwell Wright"
  CDY = "Cagayan De Sulu"
  CDZ = "Cadiz"
  CEA = "Cessna Aircraft Field"
  CEB = "Mactan-Cebu International Airport"
  CEC = "Del Norte County Regional Airport"
  CED = "Ceduna Airport"
  CEE = "Cherepovets Airport"
  CEF = "Westover ARB/Metropolitan"
  CEG = "Hawarden Airport"
  CEH = "Chelinda"
  CEI = "Chiang Rai International Airport"
  CEK = "Chelyabinsk International Airport"
  CEL = "Cape Eleuthera"
  CEM = "Central"
  CEN = "Ciudad Obregon Airport"
  CEO = "Waco Kungo"
  CEP = "Concepcion"
  CEQ = "Mandelieu"
  CER = "Maupertus"
  CES = "Cessnock"
  CET = "Le Pontreau"
  CEU = "Oconee County"
  CEV = "Mettle Field"
  CEW = "Bob Sikes"
  CEX = "Chena Hot Springs"
  CEY = "Calloway County"
  CEZ = "Montezuma County Airport"
  CFA = "Coffee Point"
  CFB = "Cabo Frio International Airport"
  CFC = "Cacador"
  CFD = "Coulter Field"
  CFE = "Clermont-Ferrand Auvergne Airport"
  CFF = "Cafunfo"
  CFG = "Jaime Gonzalez Airport"
  CFH = "Clifton Hills"
  CFI = "Camfield"
  CFK = "Chlef International Airport"
  CFM = "Conklin (Leismer) Airport"
  CFN = "Donegal Airport"
  CFO = "Confreza"
  CFP = "Carpentaria Downs"
  CFQ = "Creston Valley Airport"
  CFR = "Carpiquet Airport"
  CFS = "Coffs Harbour Airport"
  CFT = "Morenci"
  CFU = "Ioannis Kapodistrias Airport"
  CFV = "Municipal"
  CGA = "Craig SPB"
  CGB = "Marechal Rondon International Airport"
  CGC = "Cape Gloucester"
  CGD = "Changde Airport"
  CGE = "Cambridge"
  CGF = "Cuyahoga County"
  CGG = "Casiguran"
  CGH = "Sao Paulo/Congonhas Airport"
  CGI = "Cape Girardeau Airport"
  CGJ = "Chingola"
  CGK = "Soekarno-Hatta International Airport"
  CGM = "Mambajao"
  CGN = "Cologne Bonn Airport"
  CGO = "Zhengzhou Xinzheng Airport"
  CGP = "Shah Amanat International Airport"
  CGQ = "Changchun Longjia International Airport"
  CGR = "Campo Grande International Airport"
  CGS = "College Park"
  CGT = "Chinguitti"
  CGU = "Ciudad Guayana"
  CGV = "Caiguna"
  CGX = "Merrill C Meigs"
  CGY = "Laguindingan International Airport"
  CGZ = "Municipal"
  CHA = "Chattanooga Airport"
  CHB = "Chilas"
  CHC = "Christchurch International Airport"
  CHF = "Jinhae"
  CHG = "Chaoyang Airport"
  CHH = "Chachapoyas"
  CHI = "Chicago FSS"
  CHJ = "Chipinge"
  CHK = "Municipal"
  CHL = "Challis"
  CHM = "Chimbote"
  CHN = "Jeonju"
  CHO = "Charlottesville Albemarle Airport"
  CHP = "Circle Hot Springs"
  CHQ = "Chania International Airport"
  CHR = "Chateauroux"
  CHS = "Charleston International Airport"
  CHT = "Karewa"
  CHU = "Chuathbaluk Airport"
  CHV = "Chaves"
  CHW = "Jiuhuang"
  CHX = "Changuinola"
  CHY = "Choiseul Bay Airport"
  CHZ = "State"
  CIA = "Ciampino-G. B. Pastine International Airport"
  CIB = "Ap In The Sky"
  CIC = "Chico Municipal Airport"
  CID = "The Eastern Iowa Airport"
  CIE = "Collie"
  CIF = "Chifeng Airport"
  CIG = "Craig-Moffat"
  CIH = "Changzhi Airport"
  CII = "Cildir"
  CIJ = "E. Beltram Airport"
  CIK = "Chalkyitsik"
  CIL = "Melsing Creek"
  CIM = "Cimitarra"
  CIN = "Carroll"
  CIO = "MCAL Lopez"
  CIP = "Chipata"
  CIQ = "Chiquimula"
  CIR = "Cairo"
  CIS = "Canton Island"
  CIT = "Shymkent Airport"
  CIU = "Chippewa County Airport"
  CIV = "Chomley"
  CIW = "Canouan Island"
  CIX = "Cornel Ruiz Airport"
  CIY = "Comiso Airport"
  CIZ = "Coari"
  CJA = "Cajamarca Airport"
  CJB = "Coimbatore International Airport"
  CJC = "El Loa Airport"
  CJD = "Candilejas"
  CJF = "Coondewanna Airport"
  CJH = "Chilko Lake"
  CJJ = "Cheongju Airport"
  CJL = "Chitral"
  CJM = "Chumphon Airport"
  CJN = "Gillespie Field"
  CJS = "Abraham Gonzalez International Airport"
  CJT = "Copalar"
  CJU = "Jeju International Airport"
  CKA = "Kegelman Af"
  CKB = "Benedum Airport"
  CKC = "Cherkassy"
  CKD = "Crooked Creek"
  CKE = "Clear Lake"
  CKG = "Chongqing Jiangbei International Airport"
  CKH = "Chokurdah Airport"
  CKI = "Croker Island"
  CKK = "Cherokee"
  CKL = "Chkalovsky"
  CKM = "Fletcher Field"
  CKN = "Municipal"
  CKO = "Cornelio Procopio"
  CKR = "Crane Island"
  CKS = "Carajas Airport"
  CKT = "Sarakhs"
  CKU = "City"
  CKV = "Outlaw Field"
  CKW = "Christmas Creek Mine"
  CKX = "Chicken"
  CKY = "Conakry Airport"
  CKZ = "Canakkale Airport"
  CLA = "Comilla"
  CLC = "Metroport"
  CLD = "McClellan-Palomar Airport"
  CLE = "Cleveland Hopkins International Airport"
  CLG = "Coalinga"
  CLH = "Coolah"
  CLI = "Clintonville"
  CLJ = "Avram Iancu Cluj International Airport"
  CLK = "Municipal"
  CLL = "Easterwood Airport"
  CLM = "Fairchild International"
  CLN = "Carolina"
  CLO = "Alfonso B. Aragon Airport"
  CLP = "Clarks Point"
  CLQ = "Colima Airport"
  CLR = "Calipatria"
  CLS = "Centralia"
  CLT = "Charlotte Douglas International Airport"
  CLU = "Columbus Municipal"
  CLV = "Caldas Novas"
  CLW = "Executive"
  CLX = "Clorinda"
  CLY = "Sainte Catherine Airport"
  CLZ = "Calabozo"
  CMA = "Cunnamulla"
  CMC = "Camocim"
  CMD = "Cootamundra"
  CME = "Ciudad Del Carmen Airport"
  CMF = "Chambery"
  CMG = "Corumba Internacional Airport"
  CMH = "John Glenn Columbus International Airport"
  CMI = "Willard University Airport"
  CMJ = "Chi Mei"
  CMK = "Club Makokola"
  CML = "Camooweal"
  CMM = "Carmelita"
  CMN = "Mohamed V International Airport"
  CMO = "Obbia"
  CMP = "Campo Alegre"
  CMQ = "Clermont"
  CMR = "Colmar-houssen"
  CMS = "Scusciuban"
  CMT = "Cameta"
  CMU = "Chimbu"
  CMV = "Coromandel"
  CMW = "Ign Agramonte International Airport"
  CMX = "Houghton County Airport"
  CMY = "Fort Mccoy"
  CMZ = "Caia"
  CNA = "Cananea"
  CNB = "Coonamble"
  CNC = "Coconut Island"
  CND = "Kogalniceanu Airport"
  CNE = "Canon City"
  CNF = "Tancredo Neves International Airport"
  CNG = "Parvaud"
  CNH = "Municipal"
  CNI = "Changhai"
  CNJ = "Cloncurry Airport"
  CNK = "Blosser Municipal"
  CNL = "Sindal"
  CNM = "Cavern City Air Terminal"
  CNN = "Kannur International Airport"
  CNO = "Chino"
  CNP = "Neerlerit Inaat Airport"
  CNQ = "Camba Punta Airport"
  CNR = "Chanaral"
  CNS = "Cairns Airport"
  CNT = "Charata"
  CNU = "Martin Johnson"
  CNV = "Canavieiras"
  CNW = "TSTC Waco Airport"
  CNX = "Chiang Mai International Airport"
  CNY = "Canyonlands Field"
  CNZ = "Cangamba"
  COA = "Columbia"
  COB = "Coolibah"
  COC = "Concordia"
  COD = "Yellowstone Regional Airport"
  COE = "Coeur D'Alene"
  COF = "Patrick AFB"
  COG = "Mandinga"
  COH = "Cooch Behar"
  COI = "Merritt Island"
  COJ = "Coonabarabran"
  COK = "Cochin International Airport"
  COL = "Isle Of Coll"
  COM = "Coleman"
  CON = "Concord"
  COO = "Cotonou Airport"
  COP = "Cooperstown - Westville Airport"
  COQ = "Choibalsan"
  COR = "Ingeniero Aeronautico Ambrosio L.V. Taravella International Airport"
  COS = "Colorado Springs Airport"
  COT = "Cotulla"
  COU = "Columbia Regional Airport"
  COV = "Covilha"
  COW = "Coquimbo"
  COX = "Congo Town"
  COY = "Coolawanyah"
  COZ = "Constanza"
  CPA = "A. Tubman"
  CPB = "Capurgana"
  CPC = "Chapelco Airport"
  CPD = "Coober Pedy Airport"
  CPE = "Campeche International Airport"
  CPF = "Cepu"
  CPG = "Carmen De Patagones"
  CPH = "Copenhagen Airport"
  CPI = "Cape Orford"
  CPL = "Chaparral"
  CPM = "Compton"
  CPN = "Cape Rodney"
  CPO = "Chamonate Airport"
  CPP = "Coposa Airport"
  CPQ = "International"
  CPR = "Casper/Natrona County International Airport"
  CPS = "St. Louis Downtown Airport"
  CPT = "Cape Town International Airport"
  CPU = "Cururupu"
  CPV = "Joao Suassuna Airport"
  CPX = "Benjamin Rivera Noriega Airport"
  CQA = "Canarana Airport"
  CQD = "Shahre-kord"
  CQF = "Calais"
  CQM = "Ciudad Real Central"
  CQP = "Cape Flattery"
  CQS = "Costa Marques"
  CQT = "Caquetania"
  CQW = "CHERAW MUNI/LYNCH BELLINGER FLD AIRPORT"
  CRA = "Craiova Airport"
  CRB = "Collarenebri"
  CRC = "Cartago"
  CRD = "General E. Mosconi International Airport"
  CRE = "Grand Strand Airport"
  CRF = "Carnot"
  CRG = "Craig Municipal"
  CRH = "Cherribah"
  CRI = "Crooked Island Airport"
  CRJ = "Coorabie"
  CRK = "Diosdado Macapagal International (Clark International)"
  CRL = "Charleroi Brussels South Airport"
  CRM = "National Airport"
  CRO = "Corcoran"
  CRP = "Corpus Christi International Airport"
  CRQ = "Caravelas"
  CRR = "Ceres"
  CRS = "Corsicana"
  CRT = "Municipal"
  CRU = "Carriacou Island"
  CRV = "Crotone"
  CRW = "Yeager Airport"
  CRX = "Roscoe Turner"
  CRY = "Carlton Hill"
  CRZ = "Turkmenabad"
  CSA = "Isle Of Colonsay"
  CSB = "Caransebes"
  CSC = "Canas"
  CSD = "Cresswell Downs"
  CSE = "Crested Butte"
  CSF = "Creil"
  CSG = "Columbus Airport"
  CSH = "Solovky"
  CSI = "Casino"
  CSJ = "Cape St Jacques"
  CSK = "Cap Skirring"
  CSL = "O Sullivan Army Air Field"
  CSM = "Sherman"
  CSN = "Carson City"
  CSO = "Cochstedt"
  CSP = "Cape Spencer C G Heliport"
  CSQ = "Municipal"
  CSR = "Casuarito"
  CSS = "Cassilandia"
  CST = "Castaway"
  CSU = "Santa Cruz Do Sul"
  CSV = "Memorial"
  CSW = "Colorado do Oeste"
  CSX = "Changsha Huanghua Airport"
  CSY = "Cheboksary Airport"
  CSZ = "Brigadier Hector Ruiz"
  CTA = "Catania-Fontanarossa Airport"
  CTB = "Cut Bank"
  CTC = "Catamarca Airport"
  CTD = "Chitre"
  CTE = "Carti"
  CTF = "Coatepeque Airport"
  CTG = "Rafael Nunez International Airport"
  CTH = "Chestercounty Carlson"
  CTI = "Cuito Cuanavale"
  CTK = "Canton"
  CTL = "Charleville Airport"
  CTM = "Chetumal Airport"
  CTN = "Cooktown Airport"
  CTO = "Peconic River"
  CTP = "Carutapera"
  CTQ = "Do Palmar"
  CTR = "Cattle Creek"
  CTS = "New Chitose Airport"
  CTT = "Le Castellet"
  CTU = "Chengdu Shuangliu International Airport"
  CTV = "Catoca Airport"
  CTW = "Cottonwood"
  CTX = "Cortland"
  CTY = "Cross City"
  CTZ = "Sampson County"
  CUA = "Ciudad Constitución Airport"
  CUB = "Owens Field"
  CUC = "Camilo Daza International Airport"
  CUD = "Caloundra"
  CUE = "Mariscal Lamar International Airport"
  CUF = "Levaldigi Airport"
  CUG = "Cudal"
  CUH = "Municipal"
  CUI = "Currillo"
  CUJ = "Culion"
  CUK = "Caye Caulker"
  CUL = "Culiacan International Airport"
  CUM = "Cumana"
  CUN = "Cancun International Airport"
  CUO = "Caruru"
  CUP = "Carupano"
  CUQ = "Coen"
  CUR = "Curacao International Airport"
  CUS = "Municipal"
  CUT = "Cutral"
  CUU = "Gen Fierro Villalobos Airport"
  CUV = "Casigua"
  CUW = "Cube Cove"
  CUX = "Cuddihy Field"
  CUY = "Cue"
  CUZ = "Alejandro Velasco Astete International Airport"
  CVA = "Civic Ar Heli"
  CVB = "Chungribu"
  CVC = "Cleve"
  CVE = "Covenas"
  CVF = "Courchevel"
  CVG = "Cincinnati/Northern Kentucky Airport"
  CVH = "Caviahue"
  CVI = "Caleta Olivia"
  CVJ = "General Mariano Matamoros Airport"
  CVL = "Cape Vogel"
  CVM = "Ciudad Victoria Airport"
  CVN = "Clovis Municipal Airport"
  CVO = "Albany"
  CVQ = "Carnarvon Airport"
  CVR = "Hughes"
  CVS = "Cannon AFB"
  CVT = "Coventry Airport"
  CVU = "Corvo Island (Azores) Airport"
  CWA = "Central Wisconsin Airport"
  CWB = "Afonso Pena International Airport"
  CWC = "Chernivtsi International Airport"
  CWF = "Chennault International."
  CWG = "Callaway Gardens"
  CWI = "Clinton"
  CWJ = "Cangyuan Washan Airport"
  CWL = "Cardiff Airport"
  CWO = "Ft Wolter AAF"
  CWP = "Campbellpore"
  CWR = "Cowarie"
  CWS = "Center Island"
  CWT = "Cowra"
  CWW = "Corowa"
  CWX = "Cochise County Airport"
  CXA = "Caicara Del Orinoco"
  CXB = "Coxs Bazar Airport"
  CXC = "Chitina Airport"
  CXF = "Coldfoot"
  CXH = "Coal Harbour Sea Plane Base"
  CXI = "Christmas Island Airport"
  CXJ = "Hugo Cantergiani Regional Airport"
  CXL = "International"
  CXN = "Candala"
  CXO = "Montgomery Co"
  CXP = "Tunggul Wulung"
  CXQ = "Christmas Creek"
  CXR = "Cam Ranh International Airport"
  CXT = "Charters Towers"
  CXY = "Cat Cays"
  CYA = "Les Cayes"
  CYB = "Charles Kirkconnel International Airport"
  CYC = "Caye Chapel"
  CYD = "San Ignacio Town Airstrip"
  CYE = "Crystal Lake"
  CYF = "Chefornak Sea Plane Base"
  CYG = "Corryong"
  CYI = "Chiayi Airport"
  CYL = "Coyoles"
  CYM = "Chatham SPB"
  CYO = "Cayo Largo Del Sur Airport"
  CYP = "Calbayog Airport"
  CYR = "Laguna De Los Patos"
  CYS = "Cheyenne"
  CYT = "Intermediate"
  CYU = "Cuyo"
  CYW = "Celaya"
  CYX = "Cherskiy Airport"
  CYZ = "Cauayan Airport"
  CZA = "Chichen Itza"
  CZB = "Carlos Ruhl"
  CZC = "Copper Centre"
  CZE = "Coro"
  CZF = "Cape Romanzof"
  CZH = "Corozal"
  CZJ = "Corazon De Jesus"
  CZK = "Cascade Locks/Stevens"
  CZL = "Ain El Bey Airport"
  CZM = "Cozumel Airport"
  CZN = "Chisana Field"
  CZO = "Chistochina"
  CZP = "Cape Pole"
  CZS = "Campo Internacional Airport"
  CZT = "Carrizo Springs"
  CZU = "Corozal Airport"
  CZW = "Czestochowa"
  CZX = "Changzhou Airport"
  CZY = "Cluny"
  CZZ = "Campo"
  DAA = "Davison AAF"
  DAB = "Daytona Beach International Airport"
  DAC = "Hazrat Shahjalal International Airport"
  DAD = "Da Nang International Airport"
  DAF = "Daup"
  DAG = "Barstow-Daggett"
  DAH = "Dathina"
  DAJ = "Dauan Island"
  DAK = "Dakhla"
  DAL = "Dallas Love Field"
  DAM = "Damascus International Airport"
  DAN = "Municipal"
  DAO = "Dabo"
  DAP = "Darchula"
  DAR = "Julius Nyerere International Airport"
  DAS = "Great Bear Lake"
  DAT = "Datong Airport"
  DAU = "Daru Airport"
  DAV = "Enrique Malek Airport"
  DAX = "Dazhou Heshi Airport"
  DAY = "James M. Cox Dayton International Airport"
  DAZ = "Darwaz"
  DBA = "Dalbandin"
  DBB = "Alalamain International"
  DBC = "Baicheng Chang'an"
  DBD = "Dhanbad"
  DBK = "Dutch Bay SPB Seaplane Base"
  DBM = "Debra Marcos"
  DBN = "Municipal"
  DBO = "Dubbo City Regional Airport"
  DBP = "Debepare"
  DBQ = "Dubuque Municipal Airport"
  DBR = "Darbhanga Airport"
  DBS = "Dubois"
  DBT = "Debra Tabor"
  DBU = "Dambulu Oya Tank"
  DBV = "Dubrovnik Airport"
  DBY = "Dalby"
  DCA = "Ronald Reagan National Airport"
  DCF = "Canefield Airport"
  DCG = "Dubai Creek SPB"
  DCI = "Rafsu Decimomannu"
  DCK = "Dahl Creek Airport"
  DCM = "Mazamet Airport"
  DCN = "RAAF Curtin"
  DCP = "Cabin Plant Heliport"
  DCR = "Decatur Hi-Way"
  DCT = "Duncan Town"
  DCU = "Pyor"
  DCY = "Daocheng Yading Airport"
  DDC = "Dodge City Municipal Airport"
  DDD = "Dhaalu Airport"
  DDG = "Langtou Airport"
  DDI = "Daydream Island"
  DDM = "Dodoima"
  DDN = "Delta Downs"
  DDP = "Dorado Beach"
  DDR = "Shigatse Tingri Airport"
  DDU = "Dadu"
  DEA = "Dera Ghazi Khan Airport"
  DEB = "Debrecen Airport"
  DEC = "Decatur Airport"
  DED = "Dehra Dun Airport"
  DEE = "Mendeleyevo Airport"
  DEF = "Dezful Airport"
  DEH = "Municipal"
  DEI = "Denis Island"
  DEL = "Indira Gandhi International Airport"
  DEM = "Dembidollo"
  DEN = "Denver International Airport"
  DEO = "Hyatt Regency Heliport"
  DEP = "Deparizo"
  DEQ = "Deqing Moganshan Airport"
  DER = "Derim"
  DES = "Desroches"
  DET = "Detroit City"
  DEX = "Nop Goliat Airport"
  DEZ = "Al Jafrah"
  DFA = "Danfeng Airport"
  DFI = "Memorial"
  DFP = "Drumduff"
  DFW = "Dallas/Fort Worth International Airport"
  DGA = "Dangriga"
  DGB = "Danger Bay"
  DGC = "Degahbur"
  DGD = "Dalgaranga"
  DGE = "Mudgee"
  DGF = "Douglas Lake"
  DGG = "Daugo"
  DGH = "Deoghar International Airport"
  DGK = "Dugong"
  DGL = "Douglas Municipal"
  DGM = "Dongguan"
  DGN = "NAF"
  DGO = "Guadalupe Victoria Airport"
  DGP = "Daugavpils"
  DGR = "Dargaville"
  DGT = "Dumaguete Airport"
  DGU = "Dedougou"
  DGW = "Converse County"
  DHA = "King Abdulaziz AB"
  DHB = "Deer Harbor"
  DHD = "Durham Downs"
  DHF = "Al Dhafra Military Airport"
  DHG = "Dalnegorks"
  DHI = "Dhangarhi"
  DHL = "Dhala"
  DHM = "Gaggal Airport"
  DHN = "Dothan Regional Airport"
  DHO = "Horn River"
  DHR = "De Kooy/Den Helder Airport"
  DHT = "Dalhart"
  DIA = "Doha International Airport"
  DIB = "Dibrugarh Airport"
  DIE = "Antsiranana/Arrachart"
  DIG = "Diqing Shangri-La Airport"
  DIJ = "Dijon"
  DIK = "Dickinson Regional Airport"
  DIL = "Comoro Airport"
  DIM = "Dimbokro"
  DIN = "Dien Bien Airport"
  DIO = "Diomede Island"
  DIP = "Diapaga"
  DIQ = "Divinopolis"
  DIR = "Aba Tenna D Yilma Airport"
  DIS = "Loubomo"
  DIU = "Diu Airport"
  DIV = "Divo"
  DIW = "Mawella Lagoon Airport"
  DIY = "Diyarbakir Airport"
  DJA = "Djougou"
  DJB = "Sultan Thaha Airport"
  DJE = "Melita Airport"
  DJG = "Inedbirenne Airport"
  DJH = "Jebel Ali Seaplane Base"
  DJJ = "Sentani Airport"
  DJM = "Djambala"
  DJN = "Delta Junction"
  DJO = "Daloa"
  DJU = "Djupivogur"
  DKA = "Katsina"
  DKI = "Dunk Island"
  DKK = "Dunkirk"
  DKL = "Kiwigana Lodge Heliport"
  DKR = "Leopold Sedar Senghor International Airport"
  DKS = "Dikson"
  DKV = "Docker River"
  DLA = "Douala Airport"
  DLB = "Dalbertis"
  DLC = "Dalian Zhoushuizi International Airport"
  DLE = "Dole-Jura Airport"
  DLF = "Laughlin AFB"
  DLG = "Dillingham Airport"
  DLH = "Duluth International Airport"
  DLI = "Lien Khuong Airport"
  DLK = "Dulkaninna"
  DLL = "Dillon"
  DLM = "Dalaman Airport"
  DLN = "Dillon"
  DLO = "Dolomi"
  DLR = "Dalnerechensk Airport"
  DLS = "Columbia Gorge Regional/The Dalles Municipal Airport"
  DLU = "Dali Airport"
  DLV = "Delissaville"
  DLY = "Dillons Bay"
  DLZ = "Dalanzadgad"
  DMA = "Davis Monthan AFB"
  DMB = "Jambyl Airport"
  DMD = "Doomadgee Airport"
  DME = "Moscow Domodedovo Airport"
  DMK = "Don Mueang International Airport"
  DMM = "King Fahd International Airport"
  DMN = "Deming"
  DMO = "Sedalia"
  DMR = "Dhamar"
  DMT = "Diamantino"
  DMU = "Dimapur Airport"
  DNA = "Kadena AB"
  DNB = "Dunbar"
  DND = "Dundee Airport"
  DNE = "Dallas North Airport"
  DNF = "Martuba"
  DNG = "Doongan"
  DNH = "Dunhuang Airport"
  DNI = "Wad Medani"
  DNK = "Dnepropetrovsk International Airport"
  DNL = "Daniel Field"
  DNM = "Denham"
  DNN = "Municipal"
  DNO = "Dianopolis"
  DNP = "Dang"
  DNQ = "Deniliquin"
  DNR = "Pleurtuit Airport"
  DNS = "Municipal"
  DNT = "Downtown Heliport"
  DNU = "Dinangat"
  DNV = "Vermilion County"
  DNX = "Galegu"
  DNZ = "Cardak Airport"
  DOA = "Doany"
  DOB = "Dobo Airport"
  DOC = "Dornoch"
  DOD = "Dodoma Airport"
  DOE = "Djoemoe"
  DOF = "Dora Bay"
  DOG = "Dongola"
  DOH = "Hamad International Airport"
  DOI = "Doini"
  DOK = "Donetsk International Airport"
  DOL = "Saint Gatien Airport"
  DOM = "Melville Hall Airport"
  DON = "Dos Lagunas"
  DOO = "Dorobisoro"
  DOP = "Dolpa"
  DOR = "Dori"
  DOS = "Dios"
  DOU = "Dourados Airport"
  DOV = "Dover AFB"
  DOX = "Dongara"
  DOY = "Dongying Airport"
  DPA = "DuPage Airport"
  DPB = "Pampa Guanaco Airport"
  DPE = "Dieppe"
  DPG = "Michael AAF"
  DPK = "Deer Park"
  DPL = "Dipolog Airport"
  DPO = "Devonport Airport"
  DPS = "Ngurah Rai International Airport"
  DPT = "Deputatsky"
  DPU = "Dumpu"
  DQA = "Daqing Shi Airport"
  DQM = "Duqm International Airport"
  DRA = "Desert Rock"
  DRB = "Derby"
  DRC = "Dirico"
  DRD = "Dorunda Station"
  DRE = "Drummond Island"
  DRF = "Drift River"
  DRG = "Deering Airport"
  DRH = "Dabra"
  DRI = "Beauregard Parish"
  DRJ = "Drietabbetje"
  DRK = "Drake Bay"
  DRN = "Dirranbandi"
  DRO = "Durango-La Plata County Airport"
  DRR = "Durrie"
  DRS = "Dresden International Airport"
  DRT = "Del Rio International Airport"
  DRU = "Drummond"
  DRV = "Dharavandhoo AIrport"
  DRW = "Darwin International Airport"
  DRY = "Drysdale River"
  DSA = "Doncaster Sheffield Airport"
  DSC = "Dschang"
  DSD = "La Desirade"
  DSE = "Combolcha"
  DSG = "Dilasag"
  DSI = "Destin-Fort Walton Beach Airport"
  DSK = "Dera Ismail Khan"
  DSM = "Des Moines International Airport"
  DSN = "Ordos Ejin Horo Airport"
  DSO = "Sondok"
  DSS = "Blaise Diagne International Airport"
  DST = "Dubai Seaplane Terminal"
  DSV = "Dansville"
  DSX = "Dongsha Island"
  DSY = "Dara Sakor International Airport"
  DTA = "Delta"
  DTB = "Sisingamangaraja XII International Airport"
  DTD = "Datadawai"
  DTE = "Naga"
  DTH = "Death Valley"
  DTI = "Diamantina"
  DTL = "Municipal"
  DTM = "Dortmund Airport"
  DTN = "Shreveport Downtown"
  DTR = "Decatur Island"
  DTU = "Wudalianchi Dedu Airport"
  DTW = "Detroit Metropolitan Wayne County Airport"
  DUA = "Eaker"
  DUB = "Dublin Airport"
  DUC = "Halliburton Field"
  DUD = "Dunedin International Airport"
  DUE = "Dundo"
  DUF = "Pine Island Airport"
  DUG = "Bisbee-Douglas International"
  DUJ = "Du Bois-Jefferson County"
  DUK = "Dukuduk"
  DUM = "Pinang Kampai"
  DUN = "Dundas"
  DUQ = "Duncan/Quam"
  DUR = "King Shaka International Airport"
  DUS = "Dusseldorf International Airport"
  DUT = "Unalaska Airport"
  DVD = "Andavadoaka"
  DVK = "Diavik"
  DVL = "Devils Lake Airport"
  DVN = "Davenport"
  DVO = "Francisco Bangoy Intl Airport"
  DVP = "Davenport Downs"
  DVR = "Daly River"
  DVT = "Phoenix Deer Valley Airport"
  DWA = "Dwangwa"
  DWB = "Soalala"
  DWC = "Dubai World Central - Al Maktoum International Airport"
  DWD = "Dawadmi Airport"
  DWF = "Wright AFB"
  DWH = "David Wayne Hooks"
  DWN = "Downtown Airpark"
  DWO = "Diyawanna Oya Seaplane Base"
  DWR = "Dwyer Air Base"
  DWS = "Walt Disney World"
  DXB = "Dubai Airport"
  DXD = "Dixie"
  DXE = "Bruce Campbell Field"
  DXR = "Danbury Municipal Airport"
  DYA = "Dysart"
  DYG = "Zhangjiajie Hehua Airport"
  DYL = "Doylestown"
  DYM = "Diamantina Lakes"
  DYR = "Anadyr Airport"
  DYS = "Dyess AFB"
  DYU = "Dushanbe Airport"
  DYW = "Daly Waters"
  DZA = "Dzaoudzi Airport"
  DZH = "Dazhou Jinya Airport"
  DZI = "Codazzi"
  DZN = "Zhezhazgan Airport"
  DZO = "Santa Bernardina"
  DZU = "Dazu"
  EAA = "Eagle"
  EAB = "Abbse"
  EAE = "Emae"
  EAL = "Elenak"
  EAM = "Nejran"
  EAN = "Phifer Field"
  EAP = "EuroAirport Basel-Mulhouse-Freiburg Airport"
  EAR = "Kearney Regional Airport"
  EAS = "San Sebastian Airport"
  EAT = "Pangborn Field"
  EAU = "Eau Claire Airport"
  EBA = "Marina Di Campo Airport"
  EBB = "Entebbe International Airport"
  EBD = "El Obeid"
  EBG = "El Bagre"
  EBH = "El Bayadh"
  EBJ = "Esbjerg Airport"
  EBL = "Erbil International Airport"
  EBM = "El Borma"
  EBN = "Ebadon"
  EBO = "Ebon Airport"
  EBR = "Downtown"
  EBS = "Municipal"
  EBU = "Boutheon Airport"
  EBW = "Ebolowa"
  ECA = "Emmet County Airport"
  ECG = "Elizabeth City"
  ECH = "Echuca"
  ECI = "Costa Esmeralda Airport"
  ECN = "Ercan Airport"
  ECO = "El Encanto"
  ECP = "NW Florida Beaches Int"
  ECR = "El Charco"
  ECS = "Mondell"
  EDA = "Edna Bay"
  EDB = "Eldebba"
  EDD = "Erldunda"
  EDE = "Municipal"
  EDF = "Elmendorf AFB"
  EDG = "Weide AAF"
  EDI = "Edinburgh Airport"
  EDK = "El Dorado"
  EDL = "Eldoret Airport"
  EDM = "Les Ajoncs"
  EDN = "Enterprise Muni Airport"
  EDO = "Balikesir Koca Seyit Airport"
  EDQ = "Erandique"
  EDR = "Edward River"
  EDW = "Edwards AFB"
  EEA = "Aeroporto Regional do Planalto Serrano"
  EED = "Needles"
  EEK = "Eek Airport"
  EEN = "Dillant-Hopkins"
  EES = "Berenice International Airport"
  EFB = "Eight Fathom Bight"
  EFD = "Ellington Field"
  EFG = "Efogi"
  EFK = "Newport"
  EFL = "Kefallinia Airport"
  EFO = "East Fork Airport"
  EFW = "Municipal"
  EGA = "Engati"
  EGC = "Roumanieres Airport"
  EGE = "Eagle County Airport"
  EGI = "Duke Field"
  EGL = "Neghelli"
  EGM = "Sege Airport"
  EGN = "Geneina Airport"
  EGO = "Belgorod Airport"
  EGP = "Maverick Co"
  EGS = "Egilsstadir Airport"
  EGV = "Eagle River"
  EGX = "Egegik Airport"
  EHL = "El Bolson"
  EHM = "Cape Newenham"
  EHT = "Rentschler"
  EHU = "Ezhou Huahu Airport"
  EIA = "Popondetta"
  EIB = "Eisenach"
  EIE = "Eniseysk"
  EIH = "Einasleigh"
  EIK = "Yeysk"
  EIL = "Eielson AFB"
  EIN = "Eindhoven Airport"
  EIS = "Terrance B. Lettsome International Airport"
  EIY = "Ein Yahav"
  EJA = "Variguies Airport"
  EJH = "Wedjh Airport"
  EJN = "Ejin Banner Taolai Airport"
  EJT = "Enijet"
  EKA = "Murray Field"
  EKB = "Ekibastuz"
  EKD = "Elkedra"
  EKE = "Ekereku"
  EKI = "Municipal"
  EKN = "Elkins"
  EKO = "Elko Airport"
  EKS = "Shakhtyorsk Airport"
  EKT = "Eskilstuna"
  EKX = "Elizabethtown"
  ELA = "Eagle Lake"
  ELB = "San Bernado"
  ELC = "Elcho Island Airport"
  ELD = "South Arkansas Regional Airport"
  ELE = "El Real"
  ELF = "El Fasher Airport"
  ELG = "El Golea Airport"
  ELH = "North Eleuthera International Airport"
  ELI = "Elim Airport"
  ELJ = "El Recreo"
  ELK = "Municipal"
  ELL = "Ellisras"
  ELM = "Elmira Corning Regional Airport"
  ELN = "Bowers Field"
  ELO = "Eldorado"
  ELP = "El Paso International Airport"
  ELQ = "Prince Nayef bin Abdulaziz Regional Airport"
  ELR = "Elelim"
  ELS = "East London Airport"
  ELT = "Tour Sinai City"
  ELU = "Guemar Airport"
  ELV = "Elfin Cove SPB"
  ELW = "Ellamar"
  ELX = "El Tigre"
  ELY = "Yelland"
  ELZ = "Municipal"
  EMA = "East Midlands Airport"
  EMB = "Embarkadero"
  EMD = "Emerald Airport"
  EME = "Emden"
  EMG = "Empangeni"
  EMI = "Emirau"
  EMK = "Emmonak Airport"
  EML = "Emmen"
  EMM = "Kemerer"
  EMN = "Nema"
  EMO = "Emo"
  EMP = "Emporia"
  EMS = "Embessa"
  EMT = "El Monte"
  EMX = "El Maiten"
  EMY = "El Minya"
  ENA = "Kenai Municipal Airport"
  ENB = "Eneabba West"
  ENC = "Essey"
  END = "Vance AFB"
  ENE = "H. Hasan Aroeboesman Airport"
  ENF = "Enontekio"
  ENH = "Enshi Airport"
  ENI = "El Nido"
  ENJ = "El Naranjo"
  ENK = "Enniskillen St. Angelo"
  ENL = "Municipal"
  ENN = "Municipal"
  ENO = "Teniente Prim Alarcon"
  ENQ = "Coronel E Soto Cano AB"
  ENS = "Twente"
  ENT = "Enewetak Island"
  ENU = "Enugu Airport"
  ENV = "Wendover"
  ENW = "Kenosha Regional Airport"
  ENY = "Ershilipu Airport"
  EOH = "Enrique Olaya Herrera Airport"
  EOI = "Eday Airport"
  EOK = "Keokuk"
  EOR = "El Dorado"
  EOS = "Neosho"
  EOZ = "Elorza"
  EPA = "El Palomar"
  EPG = "Browns"
  EPH = "Ephrata"
  EPI = "Epi"
  EPL = "Mirecourt"
  EPN = "Epena"
  EPR = "Esperance Airport"
  EPS = "Arroyo Barril International"
  EPT = "Eliptamin"
  EPU = "Parnu"
  EQS = "Esquel Airport"
  ERA = "Erigavo"
  ERB = "Ernabella"
  ERC = "Erzincan Airport"
  ERD = "Berdyansk"
  ERE = "Erave"
  ERF = "Erfurt Airport"
  ERG = "Erbogachen Airport"
  ERH = "Moulay Ali Cherif Airport"
  ERI = "Erie International Airport"
  ERL = "Eren Hot Airport"
  ERM = "Comandante Kraemer"
  ERN = "Eirunepe"
  ERQ = "Elrose Mine"
  ERR = "Errol"
  ERS = "Eros Airport"
  ERT = "Erdenet"
  ERU = "Erume"
  ERV = "Kerrville"
  ERZ = "Erzurum Airport"
  ESA = "Esa'Ala"
  ESB = "Esenboga International Airport"
  ESC = "Delta County Airport"
  ESD = "Orcas Island Airport"
  ESE = "Ensenada"
  ESF = "Esler Field"
  ESG = "Mariscal Estigarribia"
  ESH = "Shoreham"
  ESI = "Espinosa"
  ESK = "Eskisehir"
  ESL = "Elista Airport"
  ESM = "Esmeraldas Airport"
  ESN = "Easton"
  ESO = "Espanola"
  ESP = "Birchwood-Pocono"
  ESR = "El Salvador"
  ESS = "Essen"
  EST = "Municipal"
  ESU = "Essaouira Airport"
  ESW = "State"
  ETB = "West Bend"
  ETD = "Etadunna"
  ETE = "Genda Wuha"
  ETH = "Eilat Airport"
  ETL = "Svetlaya Airport"
  ETM = "Ramon Airport"
  ETN = "Municipal"
  ETR = "Coronel Artilleria Victor Larrea Airport"
  ETS = "Municipal"
  ETZ = "Metz-Nancy-Lorraine Airport"
  EUA = "Kaufana"
  EUC = "Eucla"
  EUE = "Eureka"
  EUF = "Weedon Field"
  EUG = "Eugene Airport"
  EUM = "Neumuenster"
  EUN = "Hassan I Airport"
  EUO = "Paratebueno"
  EUQ = "Evelio Javier"
  EUX = "F D Roosevelt Airport"
  EVA = "Landing Strip"
  EVD = "Eva Downs"
  EVE = "Harstad/Narvik Airport Evenes"
  EVG = "Sveg Airport"
  EVH = "Evans Head"
  EVM = "Eveleth"
  EVN = "Zvartnots International Airport"
  EVV = "Evansville Regional Airport"
  EVW = "Evanston"
  EVX = "Evreux"
  EWB = "New Bedford Airport"
  EWD = "Wildman Lake"
  EWE = "Ewer"
  EWI = "Enarotali"
  EWK = "City-County"
  EWN = "Coastal Carolina Regional Airport"
  EWO = "Ewo"
  EWR = "Newark Liberty International Airport"
  EXI = "SPB"
  EXM = "Exmouth Gulf"
  EXT = "Exeter International Airport"
  EYK = "Beloyarsky Airport"
  EYL = "Yelimane"
  EYP = "El Yopal Airport"
  EYR = "Yerington"
  EYS = "Eliye Springs"
  EYW = "Key West International Airport"
  EZE = "Ministro Pistarini Airport"
  EZS = "Elazig Airport"
  EZV = "Berezovo"
  FAA = "Faranah"
  FAB = "Farnborough"
  FAC = "Faaite"
  FAE = "Vagar Airport"
  FAF = "Felker AAF"
  FAG = "Fagurholsmyri"
  FAH = "Farah"
  FAI = "Fairbanks International Airport"
  FAJ = "Diego Jimenez Torres"
  FAK = "False Island"
  FAL = "Falcon State"
  FAM = "Regional"
  FAO = "Faro Airport"
  FAQ = "Freida River"
  FAR = "Hector International Airport"
  FAS = "Faskrudsfjordur"
  FAT = "Fresno Yosemite International Airport"
  FAU = "Fahud"
  FAV = "Fakarava Airport"
  FAY = "Fayetteville Regional Airport"
  FAZ = "Fasa"
  FBA = "Fonte Boa"
  FBD = "Faizabad Airport"
  FBE = "Francisco Beltrao"
  FBG = "Simmons AAF"
  FBK = "Ft Wainwright"
  FBL = "Municipal"
  FBM = "Lubumbashi International Airport"
  FBR = "Fort Bridger"
  FBS = "Friday Harbor SPB"
  FBY = "Municipal"
  FCA = "Glacier Park International Airport"
  FCB = "Ficksburg Sentra Oes"
  FCH = "Fresno-Chandler"
  FCM = "Flying Cloud Airport"
  FCN = "Cuxhaven/Nordholz"
  FCO = "Leonardo da Vinci-Fiumicino Airport"
  FCS = "Butts AAF"
  FCT = "Firing Center AAF"
  FCY = "Municipal"
  FDE = "Bringeland Airport"
  FDF = "Martinique Aime Cesaire International Airport"
  FDH = "Friedrichshafen Airport"
  FDK = "Frederick Municipal"
  FDR = "Municipal"
  FDU = "Bandundu"
  FDY = "Findlay"
  FEA = "Fetlar"
  FEB = "Sanfebagar"
  FEC = "Feira De Santana"
  FEG = "Fergana Airport"
  FEJ = "Feijo"
  FEK = "Ferkessedougou"
  FEL = "Fuerstenfeldbruck"
  FEN = "Fernando De Noronha Airport"
  FEP = "Albertus"
  FES = "San Fernando"
  FET = "Municipal"
  FEW = "Warren AFB"
  FEZ = "Fes-Saiss Airport"
  FFA = "First Flight"
  FFD = "Fairford RAF Station"
  FFL = "Municipal"
  FFM = "Fergus Falls"
  FFO = "Patterson AFB"
  FFT = "Capital City"
  FFU = "Futaleufu"
  FGD = "Fderik"
  FGI = "Fagali I Airport"
  FGL = "Fox Glacier"
  FGR = "Fuengirola"
  FGU = "Fangatau"
  FHU = "Municipal"
  FHZ = "Fakahina"
  FIC = "Fire Cove"
  FID = "Elizabeth Field"
  FIE = "Fair Isle"
  FIG = "Fria"
  FIH = "N'djili Airport"
  FIK = "Finke"
  FIL = "Municipal"
  FIN = "Finschhafen"
  FIV = "Five Finger"
  FIZ = "Fitzroy Crossing"
  FJR = "Al-Fujairah International"
  FKB = "Baden-Airpark"
  FKI = "Bangoka International Airport"
  FKJ = "Fukui"
  FKL = "Venango Regional Airport"
  FKN = "Municipal"
  FKQ = "Fak Fak Airport"
  FKS = "Fukushima Airport"
  FLA = "Capitolio Airport"
  FLB = "Cangapara"
  FLC = "Falls Creek"
  FLD = "Fond Du Lac"
  FLE = "Fort Lee AAF"
  FLF = "Schaferhaus"
  FLG = "Flagstaff Pulliam Airport"
  FLH = "Flotta"
  FLI = "Flateyri"
  FLJ = "Falls Bay"
  FLL = "Fort Lauderdale-Hollywood International Airport"
  FLM = "Filadelfia"
  FLN = "Hercilio Luz International Airport"
  FLO = "Florence Airport"
  FLP = "Flippin"
  FLR = "Firenze-Peretola Airport"
  FLS = "Flinders Island Airport"
  FLT = "Flat"
  FLU = "Flushing"
  FLV = "Sherman AAF"
  FLW = "Santa Cruz Airport"
  FLX = "Municipal"
  FLY = "Finley"
  FLZ = "Ferdinand Lumban Tobing Airport"
  FMA = "El Pucu Airport"
  FMC = "Five Mile"
  FME = "Tipton AAF"
  FMG = "Flamingo"
  FMH = "Otis AFB"
  FMI = "Kalemie Airport"
  FMM = "Memmingen Allgau Airport"
  FMN = "Four Corners Regional Airport"
  FMO = "Munster Osnabruck International Airport"
  FMS = "Municipal"
  FMU = "Florence Municipal"
  FMY = "Page Field"
  FNA = "Lungi International Airport"
  FNB = "Neubrandenburg"
  FNC = "Madeira Airport"
  FND = "Funadhoo Airport"
  FNE = "Fane"
  FNG = "Fada Ngourma"
  FNH = "Fincha"
  FNI = "Garons Airport"
  FNJ = "Pyongyang Sunan International Airport"
  FNK = "Fin Creek"
  FNL = "Municipalcipal Airport"
  FNR = "SPB"
  FNT = "Bishop International Airport"
  FNU = "Fenosu"
  FOA = "Foula"
  FOB = "Fort Bragg"
  FOC = "Changle International Airport"
  FOD = "Fort Dodge Airport"
  FOE = "Forbes Field"
  FOG = "Gino Lisa"
  FOK = "Suffolk County"
  FOM = "Foumban"
  FON = "Fortuna Airport"
  FOO = "Numfoor"
  FOP = "Morris AAF"
  FOR = "Pinto Martins Airport"
  FOS = "Forrest"
  FOT = "Forster"
  FOU = "Fougamou"
  FOX = "Fox"
  FOY = "Foya"
  FPO = "Grand Bahama International Airport"
  FPR = "St Lucie County"
  FPY = "Perry-Foley"
  FRA = "Frankfurt Airport"
  FRB = "Forbes"
  FRC = "Franca"
  FRD = "Friday Harbor Airport"
  FRE = "Fera Island Airport"
  FRG = "Republic Field"
  FRH = "Municipal"
  FRI = "Marshall AAF"
  FRK = "Fregate Island"
  FRL = "Luigi Ridolfi"
  FRM = "Fairmont"
  FRN = "Bryant AAF"
  FRO = "Flora Airport"
  FRP = "Fresh Water Bay"
  FRQ = "Feramin"
  FRR = "Front Royal-Warren County"
  FRS = "Santa Elena Airport"
  FRT = "Frutillar"
  FRU = "Manas International Airport"
  FRW = "Francistown Airport"
  FRY = "Fryeburg"
  FRZ = "Fritzlar Airbase"
  FSC = "Sud Corse Airport"
  FSD = "Sioux Falls Regional Airport (Joe Foss Field)"
  FSI = "Henry Post AAF"
  FSK = "Municipal"
  FSL = "Fossil Downs"
  FSM = "Fort Smith Regional Airport"
  FSN = "Haley AAF"
  FSP = "Saint Pierre Airport"
  FSS = "Kinloss"
  FST = "Pecos County"
  FSU = "Fort Sumner"
  FSZ = "Shizuoka Airport"
  FTA = "Futuna Airport"
  FTE = "El Calafate Airport"
  FTI = "Fitiuta"
  FTK = "Godman AAF"
  FTL = "Fortuna Ledge"
  FTU = "Marillac Airport"
  FTW = "Meacham Field"
  FTX = "Owando"
  FTY = "Fulton County"
  FUB = "Fulleborn"
  FUE = "Fuerteventura Airport"
  FUG = "Fuyang Airport"
  FUJ = "Fukue Airport"
  FUK = "Fukuoka Airport"
  FUL = "Municipal"
  FUM = "Fuma"
  FUN = "Funafuti Atol International Airport"
  FUO = "Fuoshan Airport"
  FUT = "Futuna Island"
  FVL = "Flora Valey"
  FVM = "Fumawula"
  FVR = "Forrest River Airport"
  FWA = "Fort Wayne International Airport"
  FWH = "Fort Worth NAS Jrb/Carswell Field"
  FWL = "Farewell"
  FWM = "Heliport"
  FXE = "Fort Lauderdale Executive Airport"
  FXM = "Flaxman Island"
  FXO = "Cuamba"
  FXY = "Municipal"
  FYJ = "Fuyuan Dongji Airport"
  FYM = "Municipal"
  FYN = "Fuyun Koktokay Airport"
  FYT = "Faya"
  FYU = "Fort Yukon Airport"
  FYV = "Municipal (Drake Field)"
  FZL = "Fuzuli International Airport"
  FZO = "Filton"
  GAA = "Guamal"
  GAB = "Gabbs"
  GAC = "Gracias"
  GAD = "Municipal"
  GAE = "Gabès Matmata International Airport"
  GAF = "Gafsa"
  GAG = "Gage"
  GAH = "Gayndah"
  GAI = "Montgomery County"
  GAJ = "Junmachi Airport"
  GAK = "Gakona"
  GAL = "Edward G. Pitka Sr. Airport"
  GAM = "Gambell Airport"
  GAN = "Gan/Seenu Airport"
  GAO = "Los Canos Airport"
  GAP = "Gusap"
  GAQ = "Gao"
  GAR = "Garaina"
  GAS = "Garissa"
  GAT = "Tallard"
  GAU = "Lokpriya Gopinath Bordoloi International Airport"
  GAV = "Gag Island"
  GAW = "Gangaw"
  GAX = "Gamba"
  GAY = "Gaya Airport"
  GAZ = "Guasopa"
  GBA = "Big Bay"
  GBB = "Gabala International Airport"
  GBC = "Gasuke"
  GBD = "Great Bend"
  GBE = "Sir Seretse Khama International Airport"
  GBF = "Negarbo"
  GBG = "Galesburg"
  GBH = "Galbraith Lake"
  GBI = "Auxiliary Airfield"
  GBJ = "Les Bases"
  GBK = "Gbangbatok"
  GBL = "Goulburn Island"
  GBM = "Garbaharey"
  GBN = "San Giovanni Rotondo"
  GBO = "Baltimore Greenbelt T"
  GBP = "Gamboola"
  GBR = "Walter J. Koladza Airport"
  GBS = "Port Fitzroy"
  GBT = "Gorgon Airport"
  GBU = "Khashm El Girba"
  GBV = "Gibb River"
  GBW = "Ginbata Airport"
  GBZ = "Great Barrier Island"
  GCA = "Guacamaya"
  GCC = "Campbell County Airport"
  GCD = "Grand Coulee Dam"
  GCH = "Gachsaran"
  GCI = "Guernsey Airport"
  GCJ = "Grand Central"
  GCK = "Garden City Municipal Airport"
  GCM = "Owen Roberts International Airport"
  GCN = "National Park"
  GCT = "Grand Canyon Bar 10 Airport"
  GCV = "Gravatai"
  GCW = "Grand Canyon West"
  GCY = "Municipal"
  GDA = "Gounda"
  GDB = "Gondia Airport"
  GDC = "Donaldson Center"
  GDD = "Gordon Downs"
  GDE = "Gode/Iddidole Airport"
  GDG = "Magdagachi"
  GDH = "Golden Horn Lodge SPB"
  GDI = "Gordil"
  GDJ = "Gandajika"
  GDL = "Don Miguel Hidal Y Costilla International Airport"
  GDM = "Municipal"
  GDN = "Gdansk Lech Walesa Airport"
  GDO = "Vare Maria"
  GDP = "Guadalupe"
  GDQ = "Gondar Airport"
  GDR = "Angra dos Reis Airport"
  GDT = "Grand Turk Island"
  GDV = "Dawson Community Airport"
  GDW = "Gladwin"
  GDX = "Magadan Airport"
  GDZ = "Gelendzik Airport"
  GEA = "Noumea Magenta Airport"
  GEB = "Gebe"
  GEC = "Gecitkale"
  GED = "Sussex County"
  GEE = "George Town"
  GEF = "Geva Airstrip"
  GEG = "Spokane International Airport"
  GEI = "Green Islands"
  GEK = "Ganes Creek"
  GEL = "Sepe Tiaraju"
  GEM = "President Obiang Nguema International Airport"
  GEN = "Oslo Gardermoen Airport"
  GEO = "Cheddi Jagan International Airport"
  GER = "Rafael Cabrera Airport"
  GES = "General Santos International Airport"
  GET = "Geraldton Airport"
  GEV = "Gallivare Airport"
  GEW = "Gewoia"
  GEX = "Geelong"
  GEY = "South Big Horn County"
  GFA = "Malmstrom AFB"
  GFB = "Togiak Fish"
  GFD = "Pope Field"
  GFE = "Grenfell"
  GFF = "Griffith Airport"
  GFK = "Grand Forks International Airport"
  GFL = "Warren County"
  GFN = "Grafton Airport"
  GFO = "Bartica"
  GFR = "Granville"
  GFY = "Grootfontein"
  GGB = "Água Boa"
  GGC = "Lumbala"
  GGD = "Gregory Downs"
  GGE = "Georgetown"
  GGF = "Almeirim"
  GGG = "Gregg County Airport"
  GGH = "Gastão Mesquita Airport"
  GGJ = "Guaíra Airport"
  GGL = "Gilgal"
  GGM = "Kakamega Airport"
  GGN = "Gagnoa"
  GGO = "Guiglo"
  GGR = "Garoe"
  GGS = "Gobernador Gregores"
  GGT = "Exuma International Airport"
  GGW = "Glasgow International Airport"
  GHA = "Noumerate Airport"
  GHB = "Governor's Harbour Airport"
  GHC = "Great Harbour"
  GHE = "Garachine"
  GHF = "Giebelstadt"
  GHK = "Gahcho Kue Aerodrome"
  GHM = "Municipal"
  GHN = "Guanghan"
  GHS = "Melak Airport"
  GHT = "Ghat"
  GHU = "Gualeguaychu"
  GIB = "North Front Airport"
  GIC = "Boigu Island"
  GID = "Gitega"
  GIF = "Gilbert Field"
  GIG = "Galeao Antonio Carlos Jobim International Airport"
  GII = "Siguiri"
  GIL = "Gilgit Airport"
  GIM = "Miele Mimbale"
  GIR = "Girardot"
  GIS = "Gisborne Airport"
  GIT = "Geita"
  GIU = "Sigiriya Slaf Base"
  GIY = "Giyani"
  GIZ = "Jazan Regional Airport"
  GJA = "Guanaja"
  GJL = "Jijel Ferhat Abbas Airport"
  GJM = "Guajara-Mirim"
  GJR = "Gjogur"
  GJT = "Grand Junction Regional Airport"
  GKA = "Goroka Airport"
  GKD = "Gokceada"
  GKE = "Geilenkirchen"
  GKH = "Gorkha"
  GKK = "Kooddoo Airport"
  GKL = "Great Keppel Island"
  GKN = "Gulkana"
  GKO = "Kongoboumba"
  GKT = "Gatlinburg"
  GLA = "Glasgow International Airport"
  GLB = "San Calos Apache"
  GLC = "Geladi"
  GLD = "Renner Field"
  GLE = "Municipal"
  GLF = "Golfito Airport"
  GLG = "Glengyle"
  GLH = "Greenville Airport"
  GLI = "Glen Innes"
  GLK = "Galcaio"
  GLL = "Klanten Airport"
  GLM = "Glenormiston"
  GLN = "Goulimime Airport"
  GLO = "Gloucestershire"
  GLP = "Gulgubip"
  GLQ = "Glennallen"
  GLR = "Otsego County"
  GLS = "Scholes Field"
  GLT = "Gladstone Airport"
  GLU = "Gelephu Airport"
  GLV = "Golovin Airport"
  GLW = "Municipal"
  GLX = "Galela"
  GLY = "Goldsworthy"
  GLZ = "Gilze-Rijen"
  GMA = "Gemena"
  GMB = "Gambela Airport"
  GMC = "Guerima"
  GMD = "Ben Slimane"
  GME = "Gomel Airport"
  GMI = "Gasmata Island"
  GMM = "Gamboma"
  GMN = "Greymouth"
  GMO = "Gombe Lawanti International Airport"
  GMP = "Gimpo International Airport"
  GMQ = "Golog Maqin Airport"
  GMR = "Gambier Island"
  GMS = "Guimaraes"
  GMT = "Granite Mountain"
  GMU = "Greenville Downtown"
  GMV = "Monument Valley"
  GMZ = "La Gomera Airport"
  GNA = "Grodno Airport"
  GNB = "Grenoble-Isere Airport"
  GND = "Maurice Bishop International Airport"
  GNF = "Gansner Field"
  GNG = "Gooding"
  GNI = "Green Island"
  GNJ = "Ganja International Airport"
  GNM = "Guanambi"
  GNN = "Ghinnir"
  GNR = "General Roca"
  GNS = "Gunungsitoli Airport"
  GNT = "Milan"
  GNU = "Goodnews Bay"
  GNV = "Gainesville Regional Airport"
  GNY = "Sanliurfa GAP Airport"
  GNZ = "Ghanzi"
  GOA = "Genoa Cristoforo Colombo Airport"
  GOB = "Goba"
  GOC = "Gora"
  GOE = "Gonalia"
  GOF = "Goodfellow AFB"
  GOG = "Gobabis"
  GOH = "Nuuk Airport"
  GOI = "Dabolim Airport"
  GOJ = "Nizhny Novgorod International Airport"
  GOK = "Guthrie"
  GOL = "State"
  GOM = "Goma Airport"
  GON = "New London"
  GOO = "Goondiwindi"
  GOP = "Gorakhpur Airport"
  GOQ = "Golmud Airport"
  GOR = "Gore"
  GOS = "Gosford"
  GOT = "Goteborg Landvetter Airport"
  GOU = "Garoua Airport"
  GOV = "Nhulunbuy Airport"
  GOX = "Mopa Airport"
  GOY = "Amparai"
  GOZ = "Gorna Oriahovitsa"
  GPA = "Araxos Airport"
  GPB = "Tancredo Thomaz Faria"
  GPD = "Mount Gordon Mine"
  GPI = "Guapi Airport"
  GPL = "Guapiles"
  GPN = "Garden Point"
  GPO = "General Pico"
  GPS = "Baltra Airport"
  GPT = "Gulfport-Biloxi International Airport"
  GPZ = "Grand Rapids"
  GQQ = "Galion"
  GRA = "Gamarra"
  GRB = "Austin Straubel International Airport"
  GRC = "Grand Cess"
  GRD = "Greenwood"
  GRE = "Municipal"
  GRF = "Gray AAF"
  GRG = "Gardez"
  GRH = "Garuahi"
  GRI = "Grand Island Airport"
  GRJ = "George Airport"
  GRK = "Robert Gray Army Airfield"
  GRL = "Garasa"
  GRM = "Devils Track"
  GRN = "Gordon"
  GRO = "Girona-Costa Brava Airport"
  GRP = "Gurupi"
  GRQ = "Eelde Airport"
  GRR = "Gerald R. Ford International Airport"
  GRS = "Baccarini"
  GRT = "Gujrat"
  GRU = "Sao Paulo-Guarulhos International Airport"
  GRV = "Groznyy Airport"
  GRW = "Graciosa Island Airport"
  GRX = "Granada Airport"
  GRY = "Grimsey"
  GRZ = "Graz Airport"
  GSA = "Long Pasia"
  GSB = "Seymour Johnson AFB"
  GSC = "Gascoyne Junction"
  GSE = "Gothenburg City Airport"
  GSH = "Goshen"
  GSI = "Guadalcanal"
  GSJ = "Puerto San Jose"
  GSL = "Taltheilei Narrows"
  GSM = "Dayrestan Airport"
  GSN = "Mount Gunson"
  GSO = "Piedmont Triad International Airport"
  GSP = "Greenville-Spartanburg International Airport"
  GSQ = "Shark Elowainat"
  GSR = "Gardo"
  GSS = "Sabi Sabi"
  GST = "Gustavus Airport"
  GSU = "Gedaref"
  GSV = "Saratov Gagarin Airport"
  GSY = "Binbrook"
  GTA = "Gatokae Aerodrom"
  GTB = "Genting"
  GTC = "Green Turtle"
  GTE = "Alyangula Airport"
  GTF = "Great Falls International Airport"
  GTG = "Municipal"
  GTI = "Guettin"
  GTK = "Sungei Tekai"
  GTN = "Glentanner"
  GTO = "Tolotio Airport"
  GTP = "Grants Pass"
  GTR = "Golden Triangle Regional Airport"
  GTS = "Granites"
  GTT = "Georgetown Airport"
  GTW = "Holesov"
  GTY = "Gettysburg"
  GTZ = "Kirawira B"
  GUA = "La Aurora International Airport"
  GUB = "Guerrero Negro"
  GUC = "Gunnison Airport"
  GUD = "Goundam"
  GUE = "Guriaso"
  GUF = "Edwards"
  GUG = "Guari"
  GUH = "Gunnedah"
  GUI = "Guiria"
  GUJ = "Guaratingueta"
  GUL = "Goulburn"
  GUM = "A.B. Won Pat International Airport"
  GUN = "Gunter AFB"
  GUO = "Gualaco"
  GUP = "Senator Clark"
  GUQ = "Guanare"
  GUR = "Gurney Airport"
  GUS = "Grissom AFB"
  GUT = "Guetersloh"
  GUU = "Grundarfjordur"
  GUV = "Mougulu"
  GUW = "Atyrau Airport"
  GUX = "Guna"
  GUY = "Guymon"
  GUZ = "Guarapari"
  GVA = "Geneve Airport"
  GVE = "Municipal"
  GVI = "Green River"
  GVL = "Lee Gilmer Memorial"
  GVN = "May-Gatka"
  GVP = "Greenvale"
  GVR = "Governador Valadares Airport"
  GVT = "Majors Field"
  GVW = "Richards-Gebaur"
  GVX = "Sandviken"
  GWA = "Gwa"
  GWD = "Gwadar Airport"
  GWE = "Gweru"
  GWL = "Gwalior Airport"
  GWN = "Gnarowein"
  GWO = "Leflore"
  GWS = "Glenwood Springs"
  GWT = "Westerland - Sylt Airport"
  GWV = "Glendale"
  GWY = "Carnmore"
  GXA = "Beringin Airport"
  GXF = "Seiyun"
  GXG = "Negage"
  GXH = "Gannan Xiahe Airport"
  GXQ = "Ten. Vidal"
  GXX = "Yagoua"
  GXY = "Weld County"
  GYA = "Guayaramerin Airport"
  GYB = "Wodgina Airport"
  GYD = "Heydar Aliyev International Airport"
  GYE = "Jose Joaquin de Olmedo Airport"
  GYG = "Magan Airport"
  GYI = "Gisenyi"
  GYL = "Argyle"
  GYM = "Gen Jose M Yanez"
  GYN = "Santa Genoveva Airport"
  GYO = "Bandar Udara Senubung"
  GYP = "Gympie"
  GYR = "Litchfield"
  GYS = "Guang Yuan Airport"
  GYU = "Guyuan Liupanshan Airport"
  GYY = "Gary/Chicago International"
  GYZ = "Gruyere Mine Airport"
  GZA = "Gaza - Yaser Arafat International Airport"
  GZG = "Garze Gesar Airport"
  GZI = "Ghazni"
  GZM = "Gozo Heliport"
  GZO = "Gizo Airport"
  GZP = "Gazipasa Airport"
  GZT = "Gaziantep Airport"
  GZW = "Ghazvin"
  HAA = "Hasvik Airport"
  HAB = "Marion County"
  HAC = "Hachijo Jima Airport"
  HAD = "Halmstad Airport"
  HAE = "Havasupai"
  HAF = "Half Moon"
  HAH = "Prince Said Ibrahim Internatonal Airport"
  HAI = "Dr Haines"
  HAJ = "Hannover Airport"
  HAK = "Haikou Airport"
  HAL = "Halali"
  HAM = "Hamburg Airport"
  HAN = "Noi Bai International Airport"
  HAO = "Hamilton"
  HAP = "Long Island"
  HAQ = "Hanimaadhoo Airport"
  HAR = "Capital City"
  HAS = "Hail Airport"
  HAT = "Heathlands"
  HAU = "Haugesund Airport"
  HAV = "Jose Marti International Airport"
  HAW = "Haverfordwest"
  HAX = "Hatbox Field"
  HAY = "Haycock"
  HAZ = "Hatzfeldthaven"
  HBA = "Hobart International Airport"
  HBB = "Industrial Airpark"
  HBC = "Hanus Bay"
  HBD = "Habi"
  HBE = "Borg El Arab Airport"
  HBG = "The Hattiesburg-Bobby L. Chain Mun."
  HBH = "Hobart Bay"
  HBI = "Harbour Island"
  HBK = "Holbrook Municipal"
  HBN = "Flamingo"
  HBO = "Municipal"
  HBQ = "Qilian Airport"
  HBR = "Hobart"
  HBT = "Hafr Albatin"
  HBU = "Bulgan Hovd"
  HBX = "Hubli Airport"
  HCA = "Howard County"
  HCB = "Shoal Cove"
  HCC = "Columbia County"
  HCJ = "Hechi Jinchengjiang Airport"
  HCM = "Eil"
  HCN = "Hengchun"
  HCQ = "Halls Creek"
  HCR = "Holy Cross Airport"
  HCW = "Cheraw"
  HCZ = "Chenzhou Beihu Airport"
  HDA = "Hidden Falls"
  HDB = "Airfield Heidelberg"
  HDD = "Hyderabad"
  HDE = "Brewster Field"
  HDF = "Heringsdorf Airport"
  HDG = "Handan Airport"
  HDH = "Dillingham Airfield"
  HDK = "Kulhudhuffushi Airport"
  HDM = "Hamadan Airport"
  HDN = "Yampa Valley Airport"
  HDR = "Havadarya"
  HDS = "Hoedspruit Airport"
  HDY = "Hat Yai International Airport"
  HEA = "Herat International Airport"
  HEB = "Henzada"
  HED = "Herendeen"
  HEE = "Thompson-Robbins"
  HEH = "Heho Airport"
  HEI = "Heide-Buesum"
  HEK = "Heihe Airport"
  HEL = "Helsinki-Vantaa Airport"
  HEM = "Helsinki-malmi"
  HEN = "Hendon"
  HEO = "Haelogo"
  HER = "Heraklion Airport"
  HES = "State"
  HET = "Hohhot Baita International Airport"
  HEV = "Huelva"
  HEW = "Hengdian Airport"
  HEX = "Santo Domingo Herrera"
  HEY = "Hanchey Army Heliport"
  HEZ = "Hardy-Anders"
  HFA = "Haifa Airport"
  HFD = "Brainard"
  HFE = "Hefei Xinqiao Airport"
  HFF = "Mackall AAF"
  HFN = "Hornafjordur"
  HFS = "Hagfors Airport"
  HFT = "Hammerfest Airport"
  HGA = "Hargeisa Airport"
  HGD = "Hughenden"
  HGE = "Higuerote Airport"
  HGH = "Hangzhou Xiaoshan International Airport"
  HGI = "Higlieg"
  HGL = "Helgoland"
  HGN = "Mae Hong Son Airport"
  HGO = "Korhogo Airport"
  HGR = "Wash. County Regional Airport"
  HGS = "Hastings"
  HGT = "Hunter AAF"
  HGU = "Mount Hagen Airport"
  HGZ = "Hogatza"
  HHE = "Hachinohe"
  HHH = "Hilton Head Airport"
  HHI = "Wheeler AFB"
  HHN = "Frankfurt - Hahn Airport"
  HHP = "H K Heliport"
  HHQ = "Hua Hin Airport"
  HHR = "Hawthorne"
  HHZ = "Hikueru"
  HIA = "Huai'an Lianshui Airport"
  HIB = "Chisholm Airport"
  HID = "Horn Island Airport"
  HIE = "Regional"
  HIF = "Hill AFB"
  HIG = "Highbury"
  HIH = "Hook Island"
  HII = "Municipal"
  HIJ = "Hiroshima Airport"
  HIK = "Hickam AFB"
  HIL = "Shillavo"
  HIM = "Hingurakgoda"
  HIN = "Sacheon Airport"
  HIO = "Portland"
  HIP = "Headingly"
  HIR = "Honiara International Airport"
  HIS = "Hayman Island"
  HIT = "Haivaro"
  HIW = "Hiroshima West"
  HJJ = "Zhijiang Airport"
  HJR = "Khajuraho Airport"
  HJT = "Khujirt"
  HKA = "Municipal"
  HKB = "Healy Lake"
  HKD = "Hakodate Airport"
  HKG = "Hong Kong International Airport"
  HKK = "Hokitika Airport"
  HKN = "Hoskins Airport"
  HKR = "Mara North Airstrip"
  HKS = "Hawkins Field"
  HKT = "Phuket International Airport"
  HKV = "Haskovo"
  HKY = "Hickory"
  HLA = "Lanseria International Airport"
  HLB = "Hillenbrand"
  HLC = "Hill City"
  HLD = "Hulunbuir Hailar Airport"
  HLE = "Saint Helena Airport"
  HLF = "Hultsfred - Vimmerby"
  HLG = "Ohio County"
  HLH = "Ulanhot Airport"
  HLI = "Hollister"
  HLJ = "Beidahuang General Airport"
  HLL = "Hillside"
  HLM = "Park Township"
  HLN = "Helena Regional Airport"
  HLP = "Halim Perdanakusuma Airport"
  HLR = "Fort Hood AAF"
  HLS = "St Helens"
  HLT = "Hamilton"
  HLU = "Houailou"
  HLV = "Helenvale"
  HLW = "Hluhluwe"
  HLY = "Anglesey Airport"
  HLZ = "Hamilton International Airport"
  HMA = "Khanty-Mansiysk Airport"
  HMB = "Mubarak International Airport"
  HME = "Oued Irara Airport"
  HMG = "Hermannsburg"
  HMI = "Hami Airport"
  HMJ = "Khmelnitskiy"
  HMN = "Holloman AFB"
  HMO = "Gen Pesqueira Garcia Airport"
  HMR = "Hamar Airport"
  HMS = "Homeshore"
  HMT = "Ryan Field"
  HMV = "Hemavan Airport"
  HMY = "Seosan Airport"
  HNA = "Hanamaki Airport"
  HNB = "Municipal"
  HNC = "Hatteras"
  HND = "Haneda Airport"
  HNE = "Tahneta Pass"
  HNG = "Hienghene"
  HNH = "Hoonah Airport"
  HNI = "Heiweni"
  HNL = "Honolulu International Airport"
  HNM = "Hana Airport"
  HNN = "Honinabi"
  HNS = "Haines Municipal Airport"
  HNX = "Hanna"
  HNY = "Hengyang Nanyue Airport"
  HOA = "Hola"
  HOB = "Lea County Airport"
  HOC = "Komako"
  HOD = "Hodeidah Airport"
  HOE = "Houeisay"
  HOF = "Al-Ahsa Airport"
  HOG = "Frank Pais Airport"
  HOH = "Hohenems-Dornbirn"
  HOI = "Hao Island"
  HOK = "Hooker Creek"
  HOL = "Holikachu"
  HOM = "Homer Airport"
  HON = "Howes"
  HOO = "Nhon Co"
  HOP = "Campbell AAF"
  HOQ = "Hof"
  HOR = "Horta Airport"
  HOS = "Oscar Reguera"
  HOT = "Memorial Field"
  HOU = "William P. Hobby Airport"
  HOV = "Hovden Airport"
  HOW = "Howard AFB"
  HOX = "Homalin Airport"
  HOY = "Hoy Island"
  HPA = "Salote Pilolevu"
  HPB = "Hooper Bay Airport"
  HPE = "Hope Vale"
  HPG = "Shennongjia Hongping Airport"
  HPH = "Cat Bi International Airport"
  HPN = "Westchester County Airport"
  HPT = "Municipal"
  HPV = "Princeville"
  HPY = "Baytown Airport"
  HQL = "Tashkurgan Airport"
  HQM = "Bowerman"
  HRA = "Mansehra"
  HRB = "Harbin Taiping International Airport"
  HRC = "Zhairem"
  HRE = "Harare International Airport"
  HRF = "Hoarafushi Airport"
  HRG = "Hurghada International Airport"
  HRI = "Mattala Rajapaksa International Airport"
  HRJ = "Chaurjhari"
  HRK = "Kharkov Airport"
  HRL = "Valley International Airport"
  HRM = "Tilrempt"
  HRN = "Heliport"
  HRO = "Boone County Airport"
  HRR = "Herrera"
  HRS = "Harrismith Airport"
  HRT = "Linton-On-Ouse"
  HRY = "Henbury"
  HRZ = "Horizontina"
  HSA = "Hazret Sultan International Airport"
  HSB = "Raleigh"
  HSC = "Shaoguan"
  HSF = "Suifenhe Dongning Airport"
  HSG = "Saga Airport"
  HSH = "Henderson Executive"
  HSI = "Hastings"
  HSJ = "Shangjie Airport"
  HSK = "Huesca-Pirineos"
  HSL = "Huslia Airport"
  HSM = "Horsham"
  HSN = "Putuoshan Airport"
  HSP = "Ingalls Field"
  HSS = "Hissar"
  HST = "AFB"
  HSV = "Huntsville International Airport"
  HSZ = "Hsinchu"
  HTA = "Chita Airport"
  HTB = "Terre-de-Bas"
  HTG = "Hatanga Airport"
  HTH = "Hawthorne"
  HTI = "Hamilton Island Airport"
  HTL = "Roscommon County"
  HTM = "Khatgal"
  HTN = "Hotan Airport"
  HTO = "East Hampton"
  HTR = "Hateruma"
  HTS = "Tri-State/Milton Airport"
  HTT = "Huatugou Airport"
  HTU = "Hopetoun"
  HTV = "Huntsville"
  HTW = "Lawrence County Airpark"
  HTY = "Hatay Airport"
  HTZ = "Hato Corozal"
  HUA = "Redstone AAF"
  HUB = "Humbert River"
  HUC = "Humacao Airport"
  HUD = "Humboldt"
  HUE = "Humera Airport"
  HUF = "Hulman Field"
  HUG = "Huehuetenango"
  HUH = "Huahine Airport"
  HUI = "Phu Bai International Airport"
  HUJ = "Hugo"
  HUK = "Hukuntsi"
  HUL = "International"
  HUM = "Terrebonne"
  HUN = "Hualien Airport"
  HUO = "Holingol Huolinhe Airport"
  HUQ = "Houn"
  HUS = "Hughes Municipal Airport"
  HUT = "Hutchinson"
  HUU = "Huanuco Airport"
  HUV = "Hudiksvall"
  HUW = "Humaita"
  HUX = "Huatulco Airport"
  HUY = "Humberside Airport"
  HUZ = "Huizhou Airport"
  HVA = "Analalava"
  HVB = "Hervey Bay Airport"
  HVD = "Khovd Airport"
  HVE = "Intermediate"
  HVG = "Valan Airport"
  HVK = "Holmavik"
  HVN = "New Haven Airport"
  HVR = "Havre City County Airport"
  HVS = "Municipal"
  HWA = "Hawabango"
  HWD = "Hayward Executive Airport"
  HWI = "SPB"
  HWK = "Wilpena Pound"
  HWN = "Hwange Nat Park"
  HWO = "North Perry"
  HXD = "Delingha Airport"
  HXX = "Hay"
  HYA = "Barnstable Municipal Airport"
  HYC = "High Wycombe"
  HYD = "Rajiv Gandhi International Airport"
  HYF = "Hayfields"
  HYG = "Hydaburg Sea Plane Base"
  HYL = "SPB"
  HYN = "Luqiao Airport"
  HYR = "Municipal"
  HYS = "Hays Municipal Airport"
  HYV = "Hyvinkaa"
  HZA = "Establecimiento El Araza Airport"
  HZB = "Merville/Calonne"
  HZG = "Hanzhong Airport"
  HZH = "Liping Airport"
  HZK = "Husavik"
  HZL = "Hazleton"
  HZP = "Horizon"
  HZU = "Chengdu Huaizhou Airport"
  HZV = "Hazyview"
  IAA = "Igarka Airport"
  IAB = "Mcconnell AFB"
  IAD = "Washington Dulles International Airport"
  IAG = "Niagara Falls International Airport"
  IAH = "George Bush Intercontinental Airport"
  IAM = "In Amenas Airport"
  IAN = "Bob Baker Memorial Airport"
  IAO = "Sayak (Siargao)"
  IAQ = "Bahregan"
  IAR = "Tunoshna Airport"
  IAS = "Iasi Airport"
  IAU = "Iaura"
  IBA = "Ibadan Airport"
  IBB = "General Villamil"
  IBE = "Ibague Airport"
  IBI = "Iboki"
  IBL = "Indigo Bay Lodge"
  IBM = "Iron Bridge Mine Airport"
  IBO = "Ibo"
  IBP = "Iberia"
  IBR = "Ibaraki Airport"
  IBZ = "Ibiza Airport"
  ICA = "Icabaru"
  ICC = "Andrés Miguel Salazar Marcano Airport"
  ICI = "Cicia"
  ICK = "Nieuw Nickerie"
  ICL = "Municipal"
  ICN = "Incheon International Airport"
  ICO = "Sicogon Island"
  ICR = "Nicaro"
  ICS = "Cascade"
  ICT = "Wichita Dwight D. Eisenhower National Airport"
  ICY = "Icy Bay"
  IDA = "Idaho Falls Regional Airport"
  IDB = "Idre"
  IDC = "Ila Da Chilonzuene"
  IDF = "Idiofa"
  IDG = "Municipal"
  IDH = "Idaho County"
  IDI = "ndiana County Airport (Jimmy Stewart Field)"
  IDK = "Indulkana"
  IDN = "Indagen"
  IDO = "Rio"
  IDP = "Independence"
  IDR = "Devi Ahilya Bai Holkar Airport"
  IDY = "Ile d'Yeu"
  IEG = "Zielona Gora-Babimost Airport"
  IEJ = "Iejima"
  IES = "Riesa"
  IEV = "Kyiv International Airport"
  IFA = "Iowa Falls"
  IFF = "Iffley"
  IFH = "Hesa"
  IFJ = "Isafjordur Airport"
  IFL = "Innisfail"
  IFN = "Isfahan International Airport"
  IFO = "Ivano-Frankovsk Airport"
  IFP = "Laughlin Bullhead International Airport"
  IFU = "Ifuru Airport"
  IGA = "Inagua Airport"
  IGB = "Ingeniero Jacobacci"
  IGD = "Igdir"
  IGE = "Iguela"
  IGG = "Igiugig Airport"
  IGH = "Ingham"
  IGL = "Cigli AB"
  IGM = "Kingman"
  IGN = "Maria Cristina"
  IGO = "Chigorodo"
  IGR = "Cataratas del Iguazu International Airport"
  IGS = "Ingolstadt-manching"
  IGT = "Magas Airport"
  IGU = "Cataratas International Airport"
  IHA = "Niihama"
  IHC = "Inhaca"
  IHN = "Qishn"
  IHO = "Ihosy"
  IHR = "Iran Shahr"
  IHU = "Ihu"
  IIA = "Inishmaan"
  IIL = "Ilaam Airport"
  IIN = "Nishinoomote"
  IIS = "Nissan Island"
  IJK = "Izhevsk Airport"
  IJU = "J. Batista Bos Filho Airport"
  IJX = "Municipal"
  IKA = "Imam Khomeini International Airport"
  IKB = "Wilkes County"
  IKI = "Iki Airport"
  IKK = "Greater Kankakee"
  IKL = "Ikela"
  IKO = "Nikolski AFS"
  IKP = "Inkerman"
  IKS = "Tiksi Airport"
  IKT = "Irkutsk International Airport"
  IKU = "Issyk-Kul International Airport"
  ILA = "Illaga"
  ILB = "Ilha Solteira"
  ILD = "Lleida-Alguaire Airport"
  ILE = "Municipal"
  ILF = "Ilford"
  ILG = "Greater Wilmington"
  ILH = "Illis Airbase"
  ILI = "Iliamna Airport"
  ILJ = "El Recreo"
  ILK = "Ilaka"
  ILL = "Willmar"
  ILM = "Wilmington International Airport"
  ILN = "Clinton Field"
  ILO = "Mandurriao Airport"
  ILP = "Ile Des Pins Airport"
  ILQ = "Ilo"
  ILR = "Ilorin International Airport"
  ILS = "Ilopango International Airport"
  ILU = "Kilaguni"
  ILX = "Ileg"
  ILY = "Glenegedale Airport"
  ILZ = "Zilina"
  IMA = "Iamalele"
  IMB = "Imbaimadai"
  IMD = "Imonda"
  IMF = "Imphal Municipal Airport"
  IMG = "Inhaminga"
  IMI = "Ine Island"
  IMK = "Simikot"
  IML = "Imperial"
  IMM = "Immokalee"
  IMN = "Imane"
  IMO = "Zemio"
  IMP = "Imperatriz Airport"
  IMQ = "Maku International Airport"
  IMT = "Ford Airport"
  INA = "Inta Airport"
  INB = "Independence"
  INC = "Yinchuan Hedong International Airport"
  IND = "Indianapolis International Airport"
  INE = "Chinde"
  INF = "Newark Liberty International"
  ING = "Lago Argentino"
  INH = "Inhambane Airport"
  INI = "Nis Constantine the Great Airport"
  INJ = "Injune"
  INK = "Wink"
  INL = "Falls International Airport"
  INM = "Innamincka"
  INN = "Innsbruck Airport"
  INO = "Inongo"
  INQ = "Inisheer"
  INR = "Kincheloe AFB"
  INS = "Af Aux"
  INT = "Smith-Reynolds Airport"
  INU = "Nauru International"
  INV = "Inverness Airport"
  INW = "Winslow-Lindbergh"
  INX = "Inanwatan"
  INY = "Inyati"
  INZ = "In Salah Airport"
  IOA = "Ioannina Airport"
  IOK = "Iokea"
  IOM = "Isle of Man Airport"
  ION = "Impfondo"
  IOP = "Ioma"
  IOR = "Kilronan"
  IOS = "Ilheus/Bahia-Jorge Amado Airport"
  IOU = "Ile Ouen"
  IOW = "Iowa City"
  IPA = "Ipota"
  IPC = "Mataveri International Airport"
  IPE = "Ipil"
  IPG = "Ipiranga"
  IPH = "Ipoh Airport"
  IPI = "San Luis Airport"
  IPL = "Imperial County Airport"
  IPN = "Usiminas Airport"
  IPT = "Lycoming County Airport"
  IPU = "Ipiau"
  IPW = "Ipswich"
  IPZ = "San Isidro de El General Airport"
  IQA = "Al Asad Air Base"
  IQM = "Qiemo Airport"
  IQN = "Qingyang Airport"
  IQQ = "Diego Aracena International Airport"
  IQT = "C.F. Secada Vignetta International Airport"
  IRA = "Kirakira Airport"
  IRB = "Municipal"
  IRC = "Circle City"
  IRD = "Ishurdi"
  IRE = "Irece"
  IRG = "Lockhart River"
  IRI = "Nduli Airport"
  IRJ = "La Rioja Airport"
  IRK = "Kirksville Municipal Airport"
  IRM = "Igrim"
  IRN = "Iriona"
  IRO = "Birao"
  IRP = "Matari"
  IRS = "Kirsch Municipal"
  IRU = "Iranamadu SPB"
  IRZ = "Tapuruquara"
  ISA = "Mount Isa Airport"
  ISB = "Islamabad International Airport"
  ISC = "St Marys"
  ISD = "Iscuande"
  ISE = "Isparta Suleyman Demirel Airport"
  ISG = "Painushima Ishigaki Airport"
  ISH = "Ischia Airport"
  ISI = "Isisford"
  ISJ = "Isla Mujeres"
  ISK = "Gandhinagar Airport"
  ISL = "Istanbul Ataturk Airport"
  ISM = "Kissimmee Gateway"
  ISN = "Sloulin Field International Airport"
  ISO = "Stallings Field"
  ISP = "Long Island MacArthur Airport"
  ISQ = "Schoolcraft County"
  ISS = "Wiscasset"
  IST = "Istanbul New Airport"
  ISU = "Sulaimaniyah International Airport"
  ISW = "Alexander Field"
  ITA = "Itacoatiara"
  ITB = "Itaituba"
  ITE = "Itubera"
  ITH = "Ithaca Tompkins Regional Airport"
  ITI = "Itambacuri"
  ITK = "Itokama"
  ITM = "Itami Airport"
  ITN = "Itabuna"
  ITO = "Hilo International Airport"
  ITP = "Itaperuna"
  ITQ = "Itaqui"
  ITR = "Hidroeletrica"
  ITU = "Iturup"
  IUE = "Hanan Airport"
  IUL = "Ilu"
  IUM = "Summit Lake"
  IUP = "Lorenzo Airport"
  IUS = "Inus"
  IVA = "Ambanja"
  IVC = "Invercargill Airport"
  IVG = "Ivangrad"
  IVH = "Ivishak"
  IVI = "Isla Viveros"
  IVL = "Ivalo Airport"
  IVO = "Chivolo"
  IVR = "Inverell"
  IVW = "Inverway"
  IWA = "Ivanovo Yuzhny Airport"
  IWD = "Gogebic County Airport"
  IWJ = "Hagi-Iwami Airport"
  IWK = "Iwakuni Kintaikyo Airport"
  IWO = "Iwo Jima Airbase"
  IWS = "West Houston"
  IXA = "Agartala Airport"
  IXB = "Bagdogra Airport"
  IXC = "Chandigarh Airport"
  IXD = "Bamrauli Airport"
  IXE = "Mangalore Airport"
  IXG = "Belgaum Airport"
  IXH = "Kailashahar"
  IXI = "Lilabari Airport"
  IXJ = "Satwari Airport"
  IXK = "Keshod"
  IXL = "Leh Airport"
  IXM = "Madurai Airport"
  IXN = "Khowai"
  IXP = "Pathankot"
  IXQ = "Kamalpur"
  IXR = "Birsa Munda Airport"
  IXS = "Kumbhirgram Airport"
  IXT = "Pasighat"
  IXU = "Chikkalthana Airport"
  IXV = "Along"
  IXW = "Sonari"
  IXX = "Bidar Air Force Station"
  IXY = "Kandla"
  IXZ = "Port Blair Airport"
  IYK = "Kern County"
  IZA = "Zona da Mata Regional Airport"
  IZE = "Itzehoe/Hungriger Wolf Airport"
  IZO = "Izumo Airport"
  IZT = "Ixtepec"
  JAA = "Jalalabad"
  JAB = "Jabiru"
  JAC = "Jackson Hole Airport"
  JAD = "Jandakot"
  JAE = "Shumba Airport"
  JAF = "Kankesanturai"
  JAG = "Jacobabad"
  JAI = "Jaipur Airport"
  JAJ = "Perimeter Mall"
  JAK = "Jacmel Regional Airport"
  JAL = "Jalapa"
  JAM = "Jambol"
  JAN = "Jackson-Evers International Airport"
  JAO = "Beaver Ruin"
  JAP = "Punta Renes"
  JAQ = "Jacquinot Bay"
  JAR = "Jahrom"
  JAS = "County"
  JAT = "Jabot"
  JAU = "Jauja Airport"
  JAV = "Ilulissat Airport"
  JAW = "Aeroporto de Araripina"
  JAX = "Jacksonville International Airport"
  JBB = "Notohadinegoro Airport"
  JBC = "Boston City Heliport"
  JBK = "Berkeley"
  JBQ = "La Isabela International Airport"
  JBR = "Jonesboro Airport"
  JBS = "Hacienda Bus.Park Heliport"
  JBT = "City Landing"
  JCA = "Croisette Heliport"
  JCB = "Joacaba"
  JCC = "China Basin Heliport"
  JCD = "Downtown Heliport"
  JCE = "Convention Center Heliport"
  JCH = "Qasigiannguit"
  JCI = "New Century Aircenter Airport"
  JCJ = "Chuja Heliport"
  JCK = "Julia Creek"
  JCM = "Jacobina"
  JCN = "Incheon Heliport"
  JCO = "Heliport"
  JCR = "Jacareacanga"
  JCS = "Aeroporto De Crateus Airport"
  JCT = "Kimble County"
  JCU = "Ceuta Heliport"
  JCX = "Citicorp Plaza Heliport"
  JCY = "Johnson"
  JDA = "John Day"
  JDB = "Downtown Heliport"
  JDE = "Jiande Qiandaohu Airport"
  JDF = "Francisco De Assis"
  JDG = "Jeongseok"
  JDH = "Jodhpur Airport"
  JDM = "Miami Downtown Heliport"
  JDN = "Jordan"
  JDO = "Orlando Bezerra de Menezes Airport"
  JDP = "Heliport De Paris"
  JDR = "Sao Joao Del Rei"
  JDT = "Downtown Heliport"
  JDY = "Heliport"
  JDZ = "Jingdezhen Airport"
  JED = "King Abdulaziz International Airport"
  JEE = "Jeremie"
  JEF = "Memorial"
  JEG = "Aasiaat Airport"
  JEJ = "Jeh"
  JEK = "Jeki Airport"
  JEM = "Heliport"
  JEQ = "Jequie"
  JER = "Jersey Airport"
  JFK = "John F. Kennedy International Airport"
  JFM = "Heliport"
  JFN = "Ashtabula"
  JFR = "Paamiut Airport"
  JGA = "Govardhanpur Airport"
  JGB = "Jagdalpur"
  JGC = "Heliport"
  JGD = "Jiagedaqi Airport"
  JGE = "Heliport"
  JGL = "Galleria Heliport"
  JGN = "Jiayuguan Airport"
  JGO = "Qeqertarsuaq"
  JGP = "Greenway Plaza Heliport"
  JGQ = "Transco Twr Galleria"
  JGR = "Heliport"
  JGS = "Ji'An/Jing Gang Shan Airport"
  JGX = "Heliport"
  JHB = "Senai Airport"
  JHC = "Island Heliport"
  JHE = "Heliport"
  JHF = "São Paulo Catarina Executive Airport"
  JHG = "Xishuangbanna Gasa Airport"
  JHL = "Albian"
  JHM = "Kapalua Airport"
  JHS = "Sisimiut Airport"
  JHW = "Jamestown Airport"
  JHY = "Hyatt Regency Heliport"
  JIA = "Juina"
  JIB = "Djibouti-Ambouli International Airport"
  JIC = "Jinchuan Airport"
  JID = "City Of Industry Heliport"
  JIJ = "Jigiga Airport"
  JIK = "Ikaria Airport"
  JIL = "Jilin"
  JIM = "Jimma Airport"
  JIN = "Jinja"
  JIO = "International Heliport"
  JIP = "Jipijapa"
  JIQ = "Qianjiang Wulingshan Airport"
  JIR = "Jiri"
  JIU = "Jiujiang"
  JIW = "Jiwani"
  JJA = "Jajao"
  JJD = "Jericoacoara"
  JJG = "Jaguaruna Regional Airport"
  JJI = "Juanjui"
  JJM = "Mulika Lodge Airport"
  JJN = "Quanzhou Jinjiang International Airport"
  JJU = "Heliport"
  JKG = "Axamo Airport"
  JKH = "Chios Airport"
  JKL = "Kalymnos Island National Airport"
  JKR = "Janakpur Airport"
  JKV = "Cherokee County"
  JLA = "Quartz Creek"
  JLB = "Long Beach Heliport"
  JLD = "Heliport"
  JLH = "US Army Heliport"
  JLN = "Joplin Airport"
  JLR = "Jabalpur Airport"
  JLS = "Jales"
  JLX = "Union Station Heliport"
  JMA = "Marriot Astrodome"
  JMB = "Jamba"
  JMC = "Marin County"
  JMD = "Market Centre Heliport"
  JMH = "Marriott Heliport"
  JMJ = "Lancang Jingmai Airport"
  JMK = "Mikonos Airport"
  JMM = "Malmo Harbour Heliport"
  JMN = "Municipal Heliport"
  JMO = "Jomsom"
  JMS = "Jamestown Airport"
  JMU = "Jiamusi Airport"
  JMY = "Mammy Yoko Heliport"
  JNA = "Januaria"
  JNB = "O.R. Tambo International Airport"
  JNG = "Jining Airport"
  JNH = "North Park Inn Heliport"
  JNI = "Junin"
  JNJ = "Jaaluni"
  JNN = "Nanortalik"
  JNP = "Heliport"
  JNS = "Heliport"
  JNU = "Juneau International Airport"
  JNX = "Naxos Airport"
  JNZ = "Liaoning Province Airport"
  JOC = "Centerport Heliport"
  JOE = "Joensuu Airport"
  JOG = "Adisutjipto International Airport"
  JOH = "Port Saint Johns"
  JOI = "Joinville-Lauro Carneiro de Loyola Airport"
  JOJ = "Doris Lake Aerodrome"
  JOK = "Yoshkar-Ola Airport"
  JOL = "Jolo"
  JOM = "Njombe"
  JON = "Johnston Island"
  JOP = "Josephstaal"
  JOR = "The City Heliport"
  JOS = "Jos Airport"
  JOT = "Municipal"
  JPA = "Presidente Castro Pinto International Airport"
  JPD = "Heliport"
  JPE = "Nagib Demachki Airport"
  JPN = "Pentagon Army"
  JPO = "Brigadeiro Firmino Ayres Airport"
  JPR = "Ji-Parana Airport"
  JPT = "Park Ten Heliport"
  JPU = "La Defense Heliport"
  JPY = "Paraty Airport"
  JQA = "Qaarsut Airport"
  JQE = "Jaque Airport"
  JRA = "West 30th St Heliport"
  JRB = "Downtown Manhattan Heliport"
  JRC = "Municipalcipal Heliport"
  JRD = "Heliport"
  JRE = "East 60th Street Heliport"
  JRF = "Kalaeloa"
  JRG = "Jharsuguda Airport"
  JRH = "Rowriah Airport"
  JRK = "Arsuk"
  JRN = "Juruena"
  JRO = "Kilimanjaro International Airport"
  JRS = "Atarot"
  JRT = "Juruti Airport"
  JSA = "Jaisalmer"
  JSB = "Walfrido Salmito de Almeida Airport"
  JSD = "Sikorsky Heliport"
  JSG = "San Rafael Heliport"
  JSH = "Sitia Airport"
  JSI = "Skiathos Airport"
  JSJ = "Jiansanjiang Shidi Airport"
  JSK = "Municipalcipal Heliport"
  JSL = "Steel Pier Heliport"
  JSM = "Jose De San Martin"
  JSN = "Sherman Oaks Heliport"
  JSO = "Sodertalje Heliport"
  JSP = "Seogwipo Heliport"
  JSR = "Jessore Airport"
  JST = "Cambria County Airport"
  JSU = "Heliport"
  JSY = "Syros Island Airport"
  JTA = "Pedro Teixeira Castelo Airport"
  JTC = "Bauru-Arealva Airport"
  JTI = "Jatai"
  JTN = "Antônio Ribeiro Nogueira Jr. State Airport"
  JTO = "Heliport"
  JTR = "Santorini International Airport"
  JTY = "Astypalaia Airport"
  JUA = "Juara"
  JUB = "Juba International Airport"
  JUC = "Universal City Heliport"
  JUH = "Chizhou Jiuhuashan Airport"
  JUI = "Juist"
  JUJ = "El Cadillal Airport"
  JUL = "Juliaca Airport"
  JUM = "Jumla"
  JUN = "Jundah"
  JUO = "Jurado"
  JUP = "Cable Heliport"
  JUR = "Jurien Bay"
  JUT = "Juticalpa"
  JUV = "Heliport"
  JUZ = "Quzhou Airport"
  JVA = "Ankavandra"
  JVI = "Central Jersey Regional Airport"
  JVL = "Rock County"
  JWA = "Jwaneng"
  JWH = "Westchase Hilton Heliport"
  JWL = "Woodlawns"
  JWN = "Zanjan"
  JWO = "Jungwon Air Base"
  JXA = "Jixi Airport"
  JXN = "Reynolds Municipal"
  JYR = "Jiroft"
  JYV = "Jyvaskyla Airport"
  JZH = "Jiuzhai Huanglong Airport"
  KAA = "Kasama Airport"
  KAB = "Kariba"
  KAC = "Kameshly Airport"
  KAD = "Kaduna Airport"
  KAE = "SPB"
  KAF = "Karato"
  KAG = "Gangneung"
  KAH = "City Heliport"
  KAI = "Kaieteur"
  KAJ = "Kajaani Airport"
  KAK = "Kar"
  KAL = "Kaltag Airport"
  KAM = "Kamaran Island"
  KAN = "Mallam Aminu Kano International Airport"
  KAO = "Kuusamo Airport"
  KAP = "Kapanga"
  KAQ = "Kamulai"
  KAR = "Kamarang"
  KAS = "Karasburg"
  KAT = "Kaitaia"
  KAU = "Kauhava"
  KAV = "Kavanayen"
  KAW = "Kawthaung Airport"
  KAX = "Kalbarri"
  KAY = "Wakaya Island"
  KAZ = "Kau"
  KBA = "Kabala"
  KBB = "Kirkimbie"
  KBC = "Birch Creek"
  KBD = "Kimberley Downs"
  KBE = "Hot Springs SPB"
  KBF = "Karubaga"
  KBG = "Kabalega Falls"
  KBH = "Kalat"
  KBI = "Kribi"
  KBJ = "Kings Canyon"
  KBK = "Klag Bay"
  KBL = "Kabul International Airport"
  KBM = "Kabwum"
  KBN = "Kabinda"
  KBO = "Kabalo"
  KBP = "Boryspil International Airport"
  KBQ = "Kasungu"
  KBR = "Sultan Ismail Petra Airport"
  KBS = "Bo"
  KBT = "Kaben"
  KBU = "Gusti Syamsir Alam Airport"
  KBV = "Krabi Airport"
  KBW = "Chignik Bay"
  KBX = "Kambuaya"
  KBY = "Streaky Bay"
  KBZ = "Kaikoura"
  KCA = "Kuqa Airport"
  KCB = "Tepoe Airstrip"
  KCC = "Coffman Cove SPB"
  KCD = "Kamur"
  KCE = "Collinsville"
  KCF = "Kadanwari"
  KCG = "Fisheries"
  KCH = "Kuching International Airport"
  KCI = "Kon"
  KCJ = "Komaio"
  KCK = "Kirensk Airport"
  KCL = "Lagoon"
  KCM = "Kahramanmaras Airport"
  KCN = "SPB"
  KCO = "Cengiz Topel Airport"
  KCP = "Kamenets-podolskiy"
  KCQ = "Chignik"
  KCR = "Colorado Creek"
  KCS = "Kings Creek Station"
  KCT = "Koggala Airport"
  KCU = "Masindi"
  KCZ = "Kochi Ryoma Airport"
  KDA = "Kolda"
  KDB = "Kambalda"
  KDC = "Kandi"
  KDD = "Khuzdar"
  KDE = "Koroba"
  KDH = "Kandahar Airport"
  KDI = "Haluoleo Airport"
  KDJ = "Ndjole-Ville"
  KDK = "Municipal"
  KDL = "Kardla Airport"
  KDM = "Kaadedhdhoo"
  KDN = "Ndende"
  KDO = "Kadhdhoo"
  KDP = "Kandep"
  KDQ = "Kamberatoro"
  KDR = "Kandrian"
  KDS = "Kamaran Downs"
  KDT = "Kamphangsaen"
  KDU = "Skardu Airport"
  KDV = "Kandavu Airport"
  KDW = "Vic. Resevour Kandy"
  KDX = "Kadugli"
  KDY = "Mahaweli"
  KDZ = "Polgolla Reservoir Airport"
  KEA = "Keisah Airport"
  KEB = "Nanwalek"
  KEC = "Kasenga"
  KED = "Kaedi"
  KEE = "Kelle"
  KEF = "Keflavik International Airport"
  KEG = "Keglsugl"
  KEH = "Kenmore Air Harbor"
  KEI = "Kepi"
  KEJ = "Kemerovo Airport"
  KEK = "Ekwok"
  KEL = "Kiel-Holtenau"
  KEM = "Kemi/Tornio Airport"
  KEN = "Kenema"
  KEO = "Odienne"
  KEP = "Nepalganj Airport"
  KEQ = "Kebar"
  KER = "Kerman Airport"
  KES = "Kelsey"
  KET = "Keng Tung Airport"
  KEU = "Kelly Bar"
  KEV = "Halli"
  KEW = "Keewaywin"
  KEX = "Kanabea"
  KEY = "Kericho"
  KEZ = "Kelaniya River"
  KFA = "Kiffa"
  KFE = "Fortescue Dave Forrest"
  KFG = "Kalkurung"
  KFM = "Kirby Lake Aerodrome"
  KFP = "False Pass"
  KFS = "Kastamonu Airport"
  KFZ = "Kukës International Airport"
  KGA = "Kananga"
  KGB = "Konge"
  KGC = "Kingscote Airport"
  KGD = "Khrabrovo Airport"
  KGE = "Kagau"
  KGF = "Karaganda Airport"
  KGG = "Kedougou"
  KGH = "Yongai"
  KGI = "Kalgoorlie Airport"
  KGJ = "Karonga"
  KGK = "New Koliganek"
  KGL = "Kigali International Airport"
  KGM = "Kungum"
  KGN = "Kasongo Lunda"
  KGO = "Kirovograd"
  KGP = "Kogalym International Airport"
  KGR = "Kulgera"
  KGS = "Kos Airport"
  KGT = "Kangding Airport"
  KGU = "Keningau"
  KGW = "Kagi"
  KGX = "Grayling Airport"
  KGY = "Kingaroy"
  KGZ = "Glacier Creek"
  KHA = "Khaneh"
  KHC = "Kerch"
  KHD = "Khorramabad"
  KHE = "Kherson International Airport"
  KHG = "Kashi Airport"
  KHH = "Kaohsiung International Airport"
  KHI = "Jinnah International Airport"
  KHJ = "Kauhajoki"
  KHK = "Khark Island"
  KHM = "Khamti"
  KHN = "Nanchang Changbei International Airport"
  KHO = "Khoka Moya"
  KHR = "Kharkhorin"
  KHS = "Khasab Airport"
  KHT = "Khost"
  KHU = "Kremenchug"
  KHV = "Khabarovsk Airport"
  KHW = "Khwai River Lodge"
  KHX = "Savannah Airstrip"
  KHY = "Khoy"
  KHZ = "Kauehi Airport"
  KIA = "Kaiapit"
  KIB = "SPB"
  KIC = "Mesa Del Rey"
  KID = "Kristianstad Airport"
  KIE = "Aropa"
  KIF = "Kingfisher Lake"
  KIG = "Koinghaas"
  KIH = "Kish International Airport"
  KII = "Kibuli"
  KIJ = "Niigata Airport"
  KIK = "Kirkuk"
  KIL = "Kilwa"
  KIM = "Kimberley Airport"
  KIN = "Norman Manley International Airport"
  KIO = "Kili Island"
  KIP = "Kickapoo"
  KIQ = "Kira"
  KIR = "Kerry County Airport"
  KIS = "Kisumu Airport"
  KIT = "Kithira Airport"
  KIU = "Kiunga"
  KIV = "Chisinau International Airport"
  KIW = "Southdowns"
  KIX = "Kansai International Airport"
  KIY = "Kilwa Masoko Airport"
  KIZ = "Kikinonda"
  KJA = "Yemelyanovo Airport"
  KJB = "Uyyalawada Narasimha Reddy Airport"
  KJH = "Kaili Huangping Airport"
  KJI = "Kanasi Airport"
  KJK = "Kortrijk"
  KJP = "Kerama"
  KJT = "Kertajati International Airport"
  KJU = "Kamiraba"
  KJX = "Blangpidie Airport"
  KKA = "Koyuk Airport"
  KKB = "SPB"
  KKC = "Khon Kaen Airport"
  KKD = "Kokoda"
  KKE = "Kerikeri Airport"
  KKF = "Kagvik Creek"
  KKG = "Konawaruk"
  KKH = "Kongiganak Airport"
  KKI = "Spb"
  KKJ = "Kitakyushu Airport"
  KKK = "Kalakaket AFS"
  KKL = "Karluk Lake SPB"
  KKM = "Lop Buri"
  KKN = "Kirkenes Airport Hoeybuktmoen"
  KKO = "Kaikohe"
  KKP = "Koolburra"
  KKQ = "Krasnoselkup"
  KKR = "Kaukura Atoll Airport"
  KKS = "Kashan Airport"
  KKT = "Kentland"
  KKU = "Ekuk"
  KKW = "Kikwit"
  KKX = "Kikaiga Shima"
  KKY = "Kilkenny"
  KKZ = "Koh Kong"
  KLB = "Kalabo Airport"
  KLC = "Kaolack"
  KLD = "Migalovo"
  KLE = "Kaele"
  KLF = "Grabtsevo Airport"
  KLG = "Kalskag Municipal Airport"
  KLH = "Kolhapur"
  KLI = "Kota Koli"
  KLJ = "Klaipeda"
  KLK = "Kalokol"
  KLL = "Levelock"
  KLM = "Kalaleh"
  KLN = "Larsen SPB"
  KLO = "Kalibo International Airport"
  KLP = "Kelp Bay"
  KLQ = "Keluang"
  KLR = "Kalmar Oland Airport"
  KLS = "Longview"
  KLT = "Kaiserslautern"
  KLU = "Klagenfurt Airport"
  KLV = "Karlovy Vary Airport"
  KLW = "Klawock Airport"
  KLX = "Kalamata Airport"
  KLY = "Kalima"
  KLZ = "Kleinzee"
  KMA = "Kerema"
  KMB = "Koinambe"
  KMC = "King Khalid Military"
  KME = "Kamembe"
  KMF = "Kamina"
  KMG = "Kunming Changshui International Airport"
  KMH = "Kuruman"
  KMI = "Miyazaki Airport"
  KMJ = "Kumamoto Airport"
  KMK = "Makabana"
  KML = "Kamileroi"
  KMM = "Kimam"
  KMN = "Kamina"
  KMO = "Manokotak SPB"
  KMP = "J.G.H. Van Der Wath"
  KMQ = "Komatsu Airport"
  KMR = "Karimui"
  KMS = "Kumasi Airport"
  KMT = "Kampot"
  KMU = "Kismayu"
  KMV = "Kalemyo Airport"
  KMW = "Sokerkino"
  KMX = "Khamis Mushait"
  KMY = "Moser Bay"
  KMZ = "Kaoma"
  KNA = "Vina del Mar"
  KNB = "Kanab"
  KND = "Kindu"
  KNE = "Kanainj"
  KNF = "Marham RAF"
  KNG = "Kaimana Airport"
  KNH = "Kinmen Airport"
  KNI = "Katanning"
  KNJ = "Kindamba"
  KNK = "Kokhanok Airport"
  KNL = "Kelanoa"
  KNM = "Kaniama"
  KNN = "Kankan"
  KNO = "Kuala Namu International Airport"
  KNP = "Capanda"
  KNQ = "Kone"
  KNR = "Jam"
  KNS = "King Island Airport"
  KNT = "Municipal"
  KNU = "Kanpur Airport"
  KNV = "Knights Inlet"
  KNW = "New Stuyahok"
  KNX = "Kununurra Airport"
  KNY = "Kinoosao"
  KNZ = "Kenieba"
  KOA = "Kona International Airport at Keahole"
  KOC = "Koumac"
  KOD = "Kotabangun"
  KOE = "El Tari Airport"
  KOF = "Komatipoort"
  KOG = "Khong"
  KOH = "Koolatah"
  KOI = "Kirkwall Airport"
  KOJ = "Kagoshima Airport"
  KOK = "Kruunupyy Airport"
  KOL = "Koumala"
  KOM = "Komo-Manda"
  KON = "Kontum"
  KOO = "Kongolo"
  KOP = "Nakhon Phanom Airport"
  KOQ = "Koethen"
  KOR = "Kokoro"
  KOS = "Sihanouk International Airport"
  KOT = "Kotlik Airport"
  KOU = "Koulamoutou"
  KOV = "Kokshetau Airport"
  KOW = "Ganzhou Airport"
  KOX = "Kokonao"
  KOY = "Olga Bay SPB"
  KOZ = "Ouzinkie SPB"
  KPA = "Kopiago"
  KPB = "Point Baker SPB"
  KPC = "Port Clarence"
  KPD = "King Of Prussia"
  KPE = "Yapsiei"
  KPF = "Kondubol"
  KPG = "Kurupung"
  KPH = "Pauloff Harbor SPB"
  KPI = "Kapit"
  KPK = "Parks SPB"
  KPL = "Kapal"
  KPM = "Kompiam"
  KPN = "Kipnuk SPB"
  KPO = "Pohang Airport"
  KPP = "Kalpowar"
  KPR = "Port Williams SPB"
  KPS = "Kempsey"
  KPT = "Jackpot"
  KPV = "Perryville SPB"
  KPW = "Keperveyem Airport"
  KPY = "Port Bailey SPB"
  KQA = "Akutan"
  KQH = "Kishangarh Airport"
  KQL = "Kol"
  KQR = "Karara Airport"
  KQT = "Qurghonteppa International Airport"
  KRA = "Kerang"
  KRB = "Karumba Airport"
  KRC = "Kerinci"
  KRD = "Kurundi"
  KRE = "Kirundo"
  KRF = "Kramfors Airport"
  KRG = "Karasabai"
  KRI = "Kikori"
  KRJ = "Karawari"
  KRK = "J. Paul II International Airport Krakow-Balice"
  KRL = "Korla Airport"
  KRM = "Karanambo"
  KRN = "Kiruna Airport"
  KRO = "Kurgan Airport"
  KRP = "Karup Airport"
  KRQ = "Kramatorsk"
  KRR = "Krasnodar International Airport"
  KRS = "Kristiansand Airport"
  KRT = "Khartoum International Airport"
  KRU = "Kerau"
  KRV = "Kerio Valley"
  KRW = "Turkmanbashi Airport"
  KRX = "Kar Kar"
  KRY = "Karamay Airport"
  KRZ = "Kiri"
  KSA = "Kosrae Airport"
  KSB = "Kasanombe"
  KSC = "Barca Airport"
  KSD = "Karlstad Airport"
  KSE = "Kasese Airport"
  KSF = "Kassel-Calden Airport"
  KSG = "Kisengan"
  KSH = "Kermanshah Airport"
  KSI = "Kissidougou"
  KSJ = "Kasos Island Airport"
  KSK = "Karlskoga"
  KSL = "Kassala Airport"
  KSM = "Saint Mary's Airport"
  KSN = "Kostanay Airport"
  KSO = "Aristoteles Airport"
  KSP = "Kosipe"
  KSQ = "Karshi Airport"
  KSR = "Federal No 1"
  KSS = "Sikasso"
  KST = "Kosti"
  KSU = "Kristiansund Airport Kvernberget"
  KSV = "Springvale"
  KSW = "Kiryat Shmona"
  KSX = "Yasuru"
  KSY = "Kars Airport"
  KSZ = "Kotlas Airport"
  KTA = "Karratha Airport"
  KTB = "Thorne Bay"
  KTC = "Katiola"
  KTD = "Kitadaito"
  KTE = "Kerteh Airport"
  KTF = "Takaka"
  KTG = "Ketapang Airport"
  KTH = "SPB"
  KTI = "Kratie"
  KTJ = "Kichwa Tembo Airport"
  KTK = "Kanua"
  KTL = "Kitale Airport"
  KTM = "Tribhuvan International Airport"
  KTN = "Ketchikan International Airport"
  KTO = "Kato"
  KTP = "Tinson"
  KTQ = "Kitee"
  KTR = "Tindal"
  KTS = "Brevig Mission Airport"
  KTT = "Kittila Airport"
  KTU = "Kota"
  KTV = "Kamarata"
  KTW = "Katowice International Airport"
  KTX = "Koutiala"